"GEOID","GEO.display.label","pop","pop.white","pop.not.white","pct.white","pct.not.white"
"45001950100","Census Tract 9501, Abbeville County, South Carolina",3171,2749,422,0.866918953011668,0.133081046988332
"45001950200","Census Tract 9502, Abbeville County, South Carolina",4213,3066,1147,0.72774744837408,0.27225255162592
"45001950300","Census Tract 9503, Abbeville County, South Carolina",3218,3028,190,0.940957116221255,0.0590428837787446
"45001950400","Census Tract 9504, Abbeville County, South Carolina",6169,4616,1553,0.748257416112822,0.251742583887178
"45001950500","Census Tract 9505, Abbeville County, South Carolina",5248,2541,2707,0.484184451219512,0.515815548780488
"45001950600","Census Tract 9506, Abbeville County, South Carolina",3214,1552,1662,0.482887367766024,0.517112632233976
"45003020100","Census Tract 201, Aiken County, South Carolina",4743,3360,1383,0.708412397216951,0.291587602783049
"45003020200","Census Tract 202, Aiken County, South Carolina",5728,4192,1536,0.731843575418994,0.268156424581006
"45003020301","Census Tract 203.01, Aiken County, South Carolina",2490,1743,747,0.7,0.3
"45003020302","Census Tract 203.02, Aiken County, South Carolina",5254,2637,2617,0.501903311762467,0.498096688237533
"45003020400","Census Tract 204, Aiken County, South Carolina",6012,4306,1706,0.716234198270126,0.283765801729874
"45003020500","Census Tract 205, Aiken County, South Carolina",7271,5966,1305,0.820519873469949,0.179480126530051
"45003020601","Census Tract 206.01, Aiken County, South Carolina",3631,2603,1028,0.716882401542275,0.283117598457725
"45003020602","Census Tract 206.02, Aiken County, South Carolina",6982,3674,3308,0.526210254941278,0.473789745058722
"45003020701","Census Tract 207.01, Aiken County, South Carolina",6004,4435,1569,0.738674217188541,0.261325782811459
"45003020702","Census Tract 207.02, Aiken County, South Carolina",4296,2072,2224,0.482309124767225,0.517690875232775
"45003020801","Census Tract 208.01, Aiken County, South Carolina",2712,2588,124,0.954277286135693,0.0457227138643068
"45003020802","Census Tract 208.02, Aiken County, South Carolina",5249,3888,1361,0.740712516669842,0.259287483330158
"45003020901","Census Tract 209.01, Aiken County, South Carolina",2561,1727,834,0.674345958609918,0.325654041390082
"45003020902","Census Tract 209.02, Aiken County, South Carolina",6241,4391,1850,0.703573145329274,0.296426854670726
"45003021001","Census Tract 210.01, Aiken County, South Carolina",4962,3508,1454,0.706972994760177,0.293027005239823
"45003021002","Census Tract 210.02, Aiken County, South Carolina",6085,4895,1190,0.804437140509449,0.195562859490551
"45003021101","Census Tract 211.01, Aiken County, South Carolina",2685,2303,382,0.857728119180633,0.142271880819367
"45003021102","Census Tract 211.02, Aiken County, South Carolina",3783,3146,637,0.831615120274914,0.168384879725086
"45003021201","Census Tract 212.01, Aiken County, South Carolina",5563,5026,537,0.903469351069567,0.0965306489304332
"45003021202","Census Tract 212.02, Aiken County, South Carolina",3779,3416,363,0.903942842021699,0.0960571579783012
"45003021203","Census Tract 212.03, Aiken County, South Carolina",8190,7047,1143,0.86043956043956,0.13956043956044
"45003021300","Census Tract 213, Aiken County, South Carolina",5316,3999,1317,0.752257336343115,0.247742663656885
"45003021400","Census Tract 214, Aiken County, South Carolina",5713,821,4892,0.143707334150184,0.856292665849816
"45003021500","Census Tract 215, Aiken County, South Carolina",4923,3535,1388,0.718058094657729,0.281941905342271
"45003021601","Census Tract 216.01, Aiken County, South Carolina",6170,2460,3710,0.39870340356564,0.60129659643436
"45003021602","Census Tract 216.02, Aiken County, South Carolina",8151,6048,2103,0.741994847258005,0.258005152741995
"45003021700","Census Tract 217, Aiken County, South Carolina",4107,2584,1523,0.629169710250791,0.370830289749209
"45003021800","Census Tract 218, Aiken County, South Carolina",2553,1272,1281,0.498237367802585,0.501762632197415
"45003021900","Census Tract 219, Aiken County, South Carolina",6418,4424,1994,0.689311311935182,0.310688688064818
"45003022001","Census Tract 220.01, Aiken County, South Carolina",4243,2970,1273,0.699976431769974,0.300023568230026
"45003022002","Census Tract 220.02, Aiken County, South Carolina",6648,4971,1677,0.747743682310469,0.252256317689531
"45003022100","Census Tract 221, Aiken County, South Carolina",3247,2429,818,0.748075146288882,0.251924853711118
"45005970200","Census Tract 9702, Allendale County, South Carolina",5206,943,4263,0.18113714944295,0.81886285055705
"45005970300","Census Tract 9703, Allendale County, South Carolina",1114,705,409,0.632854578096948,0.367145421903052
"45005970400","Census Tract 9704, Allendale County, South Carolina",3894,819,3075,0.210323574730354,0.789676425269646
"45007000200","Census Tract 2, Anderson County, South Carolina",4564,3711,853,0.813102541630149,0.186897458369851
"45007000300","Census Tract 3, Anderson County, South Carolina",5202,3704,1498,0.7120338331411,0.2879661668589
"45007000500","Census Tract 5, Anderson County, South Carolina",3273,1026,2247,0.313473877176902,0.686526122823098
"45007000600","Census Tract 6, Anderson County, South Carolina",3213,906,2307,0.281979458450047,0.718020541549953
"45007000700","Census Tract 7, Anderson County, South Carolina",4453,1647,2806,0.36986301369863,0.63013698630137
"45007000800","Census Tract 8, Anderson County, South Carolina",2299,1516,783,0.659417137886037,0.340582862113963
"45007000900","Census Tract 9, Anderson County, South Carolina",2926,1883,1043,0.643540669856459,0.356459330143541
"45007001000","Census Tract 10, Anderson County, South Carolina",2858,2119,739,0.741427571728482,0.258572428271518
"45007001100","Census Tract 11, Anderson County, South Carolina",4998,3986,1012,0.797519007603041,0.202480992396959
"45007010102","Census Tract 101.02, Anderson County, South Carolina",6509,6246,263,0.959594407743125,0.0404055922568751
"45007010103","Census Tract 101.03, Anderson County, South Carolina",7064,6441,623,0.911806342015855,0.0881936579841449
"45007010104","Census Tract 101.04, Anderson County, South Carolina",8015,7562,453,0.943480973175296,0.0565190268247037
"45007010200","Census Tract 102, Anderson County, South Carolina",4847,4728,119,0.975448731173922,0.0245512688260779
"45007010300","Census Tract 103, Anderson County, South Carolina",4165,3798,367,0.911884753901561,0.0881152460984393
"45007010401","Census Tract 104.01, Anderson County, South Carolina",6128,5356,772,0.87402088772846,0.12597911227154
"45007010402","Census Tract 104.02, Anderson County, South Carolina",5753,5349,404,0.929775769163914,0.0702242308360855
"45007010500","Census Tract 105, Anderson County, South Carolina",6338,5371,967,0.847428210792048,0.152571789207952
"45007010600","Census Tract 106, Anderson County, South Carolina",7301,6594,707,0.903163950143816,0.0968360498561841
"45007010700","Census Tract 107, Anderson County, South Carolina",5254,4055,1199,0.771792919680244,0.228207080319756
"45007010800","Census Tract 108, Anderson County, South Carolina",4910,4434,476,0.903054989816701,0.0969450101832994
"45007010900","Census Tract 109, Anderson County, South Carolina",4276,4013,263,0.938493919550982,0.0615060804490177
"45007011001","Census Tract 110.01, Anderson County, South Carolina",4657,4432,225,0.951685634528667,0.0483143654713335
"45007011002","Census Tract 110.02, Anderson County, South Carolina",4096,3576,520,0.873046875,0.126953125
"45007011100","Census Tract 111, Anderson County, South Carolina",2749,2129,620,0.774463441251364,0.225536558748636
"45007011201","Census Tract 112.01, Anderson County, South Carolina",3846,3252,594,0.845553822152886,0.154446177847114
"45007011202","Census Tract 112.02, Anderson County, South Carolina",7715,6858,857,0.888917692806222,0.111082307193778
"45007011300","Census Tract 113, Anderson County, South Carolina",7527,6079,1448,0.80762588016474,0.19237411983526
"45007011401","Census Tract 114.01, Anderson County, South Carolina",4145,3046,1099,0.734861278648975,0.265138721351025
"45007011402","Census Tract 114.02, Anderson County, South Carolina",3130,2572,558,0.821725239616613,0.178274760383387
"45007011500","Census Tract 115, Anderson County, South Carolina",6555,5571,984,0.849885583524027,0.150114416475973
"45007011600","Census Tract 116, Anderson County, South Carolina",2054,1899,155,0.924537487828627,0.0754625121713729
"45007011700","Census Tract 117, Anderson County, South Carolina",5932,4986,946,0.840525960890088,0.159474039109912
"45007011800","Census Tract 118, Anderson County, South Carolina",3932,3414,518,0.868260427263479,0.131739572736521
"45007011901","Census Tract 119.01, Anderson County, South Carolina",5252,3348,1904,0.637471439451637,0.362528560548363
"45007011902","Census Tract 119.02, Anderson County, South Carolina",2885,1574,1311,0.545580589254766,0.454419410745234
"45007012001","Census Tract 120.01, Anderson County, South Carolina",4865,3678,1187,0.75601233299075,0.24398766700925
"45007012002","Census Tract 120.02, Anderson County, South Carolina",4616,3343,1273,0.724220103986135,0.275779896013865
"45007012200","Census Tract 122, Anderson County, South Carolina",6419,5320,1099,0.828789531079607,0.171210468920393
"45007012300","Census Tract 123, Anderson County, South Carolina",3759,1908,1851,0.507581803671189,0.492418196328811
"45009960100","Census Tract 9601, Bamberg County, South Carolina",6073,659,5414,0.108513090729458,0.891486909270542
"45009960200","Census Tract 9602, Bamberg County, South Carolina",6972,3105,3867,0.445352839931153,0.554647160068847
"45009960300","Census Tract 9603, Bamberg County, South Carolina",1480,1069,411,0.722297297297297,0.277702702702703
"45009960400","Census Tract 9604, Bamberg County, South Carolina",1289,863,426,0.669511249030256,0.330488750969744
"45011970100","Census Tract 9701, Barnwell County, South Carolina",5540,3057,2483,0.551805054151625,0.448194945848375
"45011970200","Census Tract 9702, Barnwell County, South Carolina",4254,1348,2906,0.316878232251998,0.683121767748002
"45011970300","Census Tract 9703, Barnwell County, South Carolina",4256,1834,2422,0.430921052631579,0.569078947368421
"45011970400","Census Tract 9704, Barnwell County, South Carolina",4728,3827,901,0.809433164128596,0.190566835871404
"45011970500","Census Tract 9705, Barnwell County, South Carolina",3621,1708,1913,0.471692902513118,0.528307097486882
"45013000100","Census Tract 1, Beaufort County, South Carolina",4444,1628,2816,0.366336633663366,0.633663366336634
"45013000200","Census Tract 2, Beaufort County, South Carolina",5084,1877,3207,0.369197482297404,0.630802517702596
"45013000300","Census Tract 3, Beaufort County, South Carolina",5063,4178,885,0.825202449140826,0.174797550859174
"45013000400","Census Tract 4, Beaufort County, South Carolina",1270,877,393,0.690551181102362,0.309448818897638
"45013000501","Census Tract 5.01, Beaufort County, South Carolina",6359,3530,2829,0.555118729359962,0.444881270640038
"45013000502","Census Tract 5.02, Beaufort County, South Carolina",4922,2749,2173,0.558512799674929,0.441487200325071
"45013000503","Census Tract 5.03, Beaufort County, South Carolina",4473,3023,1450,0.675832774424324,0.324167225575676
"45013000600","Census Tract 6, Beaufort County, South Carolina",2456,1696,760,0.690553745928339,0.309446254071661
"45013000700","Census Tract 7, Beaufort County, South Carolina",6301,4023,2278,0.638470084113633,0.361529915886367
"45013000800","Census Tract 8, Beaufort County, South Carolina",4464,2491,1973,0.558019713261649,0.441980286738351
"45013000901","Census Tract 9.01, Beaufort County, South Carolina",2652,2248,404,0.847662141779789,0.152337858220211
"45013000902","Census Tract 9.02, Beaufort County, South Carolina",7961,6696,1265,0.841100364275845,0.158899635724155
"45013000903","Census Tract 9.03, Beaufort County, South Carolina",1436,1028,408,0.715877437325905,0.284122562674095
"45013001000","Census Tract 10, Beaufort County, South Carolina",5444,3763,1681,0.69121969140338,0.30878030859662
"45013001101","Census Tract 11.01, Beaufort County, South Carolina",3579,2119,1460,0.592064822576139,0.407935177423861
"45013001102","Census Tract 11.02, Beaufort County, South Carolina",5203,1054,4149,0.202575437247742,0.797424562752258
"45013001200","Census Tract 12, Beaufort County, South Carolina",885,851,34,0.961581920903955,0.0384180790960452
"45013002101","Census Tract 21.01, Beaufort County, South Carolina",603,593,10,0.983416252072968,0.0165837479270315
"45013002102","Census Tract 21.02, Beaufort County, South Carolina",1862,1572,290,0.844253490870032,0.155746509129968
"45013002103","Census Tract 21.03, Beaufort County, South Carolina",2996,2312,684,0.771695594125501,0.228304405874499
"45013002104","Census Tract 21.04, Beaufort County, South Carolina",11700,11294,406,0.965299145299145,0.0347008547008547
"45013002105","Census Tract 21.05, Beaufort County, South Carolina",2771,2217,554,0.800072176109708,0.199927823890292
"45013002106","Census Tract 21.06, Beaufort County, South Carolina",9068,6826,2242,0.752756947507719,0.247243052492281
"45013002107","Census Tract 21.07, Beaufort County, South Carolina",10761,7749,3012,0.720100362419849,0.279899637580151
"45013002108","Census Tract 21.08, Beaufort County, South Carolina",4958,3962,996,0.799112545381202,0.200887454618798
"45013002201","Census Tract 22.01, Beaufort County, South Carolina",6570,6144,426,0.935159817351598,0.0648401826484019
"45013002202","Census Tract 22.02, Beaufort County, South Carolina",3288,2983,305,0.907238442822384,0.0927615571776156
"45013010100","Census Tract 101, Beaufort County, South Carolina",1715,1678,37,0.978425655976676,0.0215743440233236
"45013010200","Census Tract 102, Beaufort County, South Carolina",3332,2945,387,0.883853541416567,0.116146458583433
"45013010300","Census Tract 103, Beaufort County, South Carolina",4166,3898,268,0.935669707153144,0.0643302928468555
"45013010400","Census Tract 104, Beaufort County, South Carolina",5729,4635,1094,0.809041717577239,0.190958282422761
"45013010500","Census Tract 105, Beaufort County, South Carolina",3803,2426,1377,0.637917433605049,0.362082566394951
"45013010600","Census Tract 106, Beaufort County, South Carolina",4108,4008,100,0.975657254138267,0.0243427458617332
"45013010700","Census Tract 107, Beaufort County, South Carolina",4557,4407,150,0.967083607636603,0.0329163923633969
"45013010800","Census Tract 108, Beaufort County, South Carolina",3813,1490,2323,0.39076842381327,0.60923157618673
"45013010900","Census Tract 109, Beaufort County, South Carolina",1552,1392,160,0.896907216494845,0.103092783505155
"45013011000","Census Tract 110, Beaufort County, South Carolina",1695,1335,360,0.787610619469027,0.212389380530973
"45013011100","Census Tract 111, Beaufort County, South Carolina",2221,2067,154,0.930661864025214,0.0693381359747861
"45013011200","Census Tract 112, Beaufort County, South Carolina",667,655,12,0.982008995502249,0.0179910044977512
"45013011300","Census Tract 113, Beaufort County, South Carolina",1423,1314,109,0.92340126493324,0.0765987350667604
"45015020101","Census Tract 201.01, Berkeley County, South Carolina",3061,1189,1872,0.38843515191114,0.61156484808886
"45015020102","Census Tract 201.02, Berkeley County, South Carolina",4040,2630,1410,0.650990099009901,0.349009900990099
"45015020201","Census Tract 202.01, Berkeley County, South Carolina",4346,1894,2452,0.435803037275656,0.564196962724344
"45015020202","Census Tract 202.02, Berkeley County, South Carolina",2868,184,2684,0.0641562064156206,0.935843793584379
"45015020301","Census Tract 203.01, Berkeley County, South Carolina",2784,2492,292,0.895114942528736,0.104885057471264
"45015020302","Census Tract 203.02, Berkeley County, South Carolina",6896,4132,2764,0.599187935034803,0.400812064965197
"45015020401","Census Tract 204.01, Berkeley County, South Carolina",3834,2029,1805,0.529212310902452,0.470787689097548
"45015020403","Census Tract 204.03, Berkeley County, South Carolina",6441,5819,622,0.903431144232262,0.0965688557677379
"45015020404","Census Tract 204.04, Berkeley County, South Carolina",4081,3387,694,0.829943641264396,0.170056358735604
"45015020405","Census Tract 204.05, Berkeley County, South Carolina",2673,1036,1637,0.38757949869061,0.61242050130939
"45015020503","Census Tract 205.03, Berkeley County, South Carolina",5013,3112,1901,0.620785956513066,0.379214043486934
"45015020504","Census Tract 205.04, Berkeley County, South Carolina",4095,1979,2116,0.483272283272283,0.516727716727717
"45015020505","Census Tract 205.05, Berkeley County, South Carolina",3045,1851,1194,0.607881773399015,0.392118226600985
"45015020506","Census Tract 205.06, Berkeley County, South Carolina",5220,3134,2086,0.600383141762452,0.399616858237548
"45015020600","Census Tract 206, Berkeley County, South Carolina",5978,4536,1442,0.758782201405152,0.241217798594848
"45015020707","Census Tract 207.07, Berkeley County, South Carolina",5966,4443,1523,0.744720080455917,0.255279919544083
"45015020710","Census Tract 207.10, Berkeley County, South Carolina",5270,3499,1771,0.663946869070209,0.336053130929791
"45015020711","Census Tract 207.11, Berkeley County, South Carolina",3317,2777,540,0.837202291227012,0.162797708772988
"45015020712","Census Tract 207.12, Berkeley County, South Carolina",3403,3103,300,0.911842491918895,0.0881575080811049
"45015020713","Census Tract 207.13, Berkeley County, South Carolina",2298,1957,341,0.851610095735422,0.148389904264578
"45015020714","Census Tract 207.14, Berkeley County, South Carolina",5788,4142,1646,0.715618521078093,0.284381478921907
"45015020715","Census Tract 207.15, Berkeley County, South Carolina",4948,3574,1374,0.722312045270816,0.277687954729184
"45015020716","Census Tract 207.16, Berkeley County, South Carolina",7964,5614,2350,0.704922149673531,0.295077850326469
"45015020717","Census Tract 207.17, Berkeley County, South Carolina",5200,3654,1546,0.702692307692308,0.297307692307692
"45015020718","Census Tract 207.18, Berkeley County, South Carolina",4010,2834,1176,0.706733167082294,0.293266832917706
"45015020719","Census Tract 207.19, Berkeley County, South Carolina",6700,5024,1676,0.749850746268657,0.250149253731343
"45015020720","Census Tract 207.20, Berkeley County, South Carolina",3485,2902,583,0.832711621233859,0.167288378766141
"45015020721","Census Tract 207.21, Berkeley County, South Carolina",3744,2707,1037,0.723023504273504,0.276976495726496
"45015020722","Census Tract 207.22, Berkeley County, South Carolina",3449,3109,340,0.901420701652653,0.098579298347347
"45015020723","Census Tract 207.23, Berkeley County, South Carolina",2800,2040,760,0.728571428571429,0.271428571428571
"45015020724","Census Tract 207.24, Berkeley County, South Carolina",3151,2756,395,0.87464297048556,0.12535702951444
"45015020725","Census Tract 207.25, Berkeley County, South Carolina",1185,737,448,0.621940928270042,0.378059071729958
"45015020804","Census Tract 208.04, Berkeley County, South Carolina",2927,1230,1697,0.420225486846601,0.579774513153399
"45015020806","Census Tract 208.06, Berkeley County, South Carolina",3465,2558,907,0.738239538239538,0.261760461760462
"45015020807","Census Tract 208.07, Berkeley County, South Carolina",6765,3642,3123,0.538359201773836,0.461640798226164
"45015020808","Census Tract 208.08, Berkeley County, South Carolina",3424,1974,1450,0.576518691588785,0.423481308411215
"45015020809","Census Tract 208.09, Berkeley County, South Carolina",3445,2157,1288,0.626124818577649,0.373875181422351
"45015020810","Census Tract 208.10, Berkeley County, South Carolina",3858,2253,1605,0.58398133748056,0.41601866251944
"45015020811","Census Tract 208.11, Berkeley County, South Carolina",4834,2496,2338,0.516342573438146,0.483657426561854
"45015020812","Census Tract 208.12, Berkeley County, South Carolina",5183,3911,1272,0.754582288250048,0.245417711749952
"45015020901","Census Tract 209.01, Berkeley County, South Carolina",1494,1106,388,0.740294511378849,0.259705488621151
"45015020903","Census Tract 209.03, Berkeley County, South Carolina",3348,2662,686,0.795101553166069,0.204898446833931
"45015020904","Census Tract 209.04, Berkeley County, South Carolina",3688,2533,1155,0.686822125813449,0.313177874186551
"45015021000","Census Tract 210, Berkeley County, South Carolina",4882,3639,1243,0.745391233101188,0.254608766898812
"45017950100","Census Tract 9501, Calhoun County, South Carolina",5740,3730,2010,0.649825783972125,0.350174216027875
"45017950200","Census Tract 9502, Calhoun County, South Carolina",5986,2710,3276,0.452723020380889,0.547276979619111
"45017950400","Census Tract 9504, Calhoun County, South Carolina",3383,1927,1456,0.569612769731008,0.430387230268992
"45019000100","Census Tract 1, Charleston County, South Carolina",2875,2534,341,0.881391304347826,0.118608695652174
"45019000200","Census Tract 2, Charleston County, South Carolina",1407,1407,0,1,0
"45019000400","Census Tract 4, Charleston County, South Carolina",3501,2813,688,0.803484718651814,0.196515281348186
"45019000500","Census Tract 5, Charleston County, South Carolina",1999,1904,95,0.95247623811906,0.0475237618809404
"45019000600","Census Tract 6, Charleston County, South Carolina",1306,1070,236,0.819295558958652,0.180704441041348
"45019000700","Census Tract 7, Charleston County, South Carolina",3024,2160,864,0.714285714285714,0.285714285714286
"45019000900","Census Tract 9, Charleston County, South Carolina",1442,257,1185,0.178224687933426,0.821775312066574
"45019001000","Census Tract 10, Charleston County, South Carolina",2291,1443,848,0.629855958096901,0.370144041903099
"45019001100","Census Tract 11, Charleston County, South Carolina",2268,664,1604,0.292768959435626,0.707231040564374
"45019001500","Census Tract 15, Charleston County, South Carolina",1453,395,1058,0.271851342050929,0.728148657949071
"45019001600","Census Tract 16, Charleston County, South Carolina",1407,808,599,0.574271499644634,0.425728500355366
"45019001901","Census Tract 19.01, Charleston County, South Carolina",3687,3164,523,0.858150257662056,0.141849742337944
"45019001902","Census Tract 19.02, Charleston County, South Carolina",4308,3298,1010,0.765552460538533,0.234447539461467
"45019002002","Census Tract 20.02, Charleston County, South Carolina",5444,4886,558,0.897501836884644,0.102498163115356
"45019002003","Census Tract 20.03, Charleston County, South Carolina",8265,5467,2798,0.661464004839685,0.338535995160315
"45019002004","Census Tract 20.04, Charleston County, South Carolina",2162,1944,218,0.899167437557817,0.100832562442183
"45019002005","Census Tract 20.05, Charleston County, South Carolina",5953,5532,421,0.929279354947085,0.0707206450529145
"45019002006","Census Tract 20.06, Charleston County, South Carolina",4414,3557,857,0.80584503851382,0.19415496148618
"45019002007","Census Tract 20.07, Charleston County, South Carolina",3559,3363,196,0.944928350660298,0.0550716493397022
"45019002101","Census Tract 21.01, Charleston County, South Carolina",12438,9074,3364,0.729538511014633,0.270461488985367
"45019002103","Census Tract 21.03, Charleston County, South Carolina",3785,2339,1446,0.617965653896962,0.382034346103038
"45019002104","Census Tract 21.04, Charleston County, South Carolina",1365,1365,0,1,0
"45019002105","Census Tract 21.05, Charleston County, South Carolina",1844,1828,16,0.991323210412148,0.00867678958785245
"45019002200","Census Tract 22, Charleston County, South Carolina",2924,1302,1622,0.445280437756498,0.554719562243502
"45019002300","Census Tract 23, Charleston County, South Carolina",1500,767,733,0.511333333333333,0.488666666666667
"45019002400","Census Tract 24, Charleston County, South Carolina",3980,1666,2314,0.418592964824121,0.581407035175879
"45019002502","Census Tract 25.02, Charleston County, South Carolina",7475,3872,3603,0.517993311036789,0.482006688963211
"45019002604","Census Tract 26.04, Charleston County, South Carolina",3757,2881,876,0.766835240883684,0.233164759116316
"45019002605","Census Tract 26.05, Charleston County, South Carolina",3815,1876,1939,0.491743119266055,0.508256880733945
"45019002606","Census Tract 26.06, Charleston County, South Carolina",2152,1787,365,0.830390334572491,0.169609665427509
"45019002611","Census Tract 26.11, Charleston County, South Carolina",3088,2402,686,0.777849740932642,0.222150259067358
"45019002612","Census Tract 26.12, Charleston County, South Carolina",6543,3747,2796,0.572673085740486,0.427326914259514
"45019002613","Census Tract 26.13, Charleston County, South Carolina",5034,4129,905,0.820222487087803,0.179777512912197
"45019002614","Census Tract 26.14, Charleston County, South Carolina",3702,2244,1458,0.606158833063209,0.393841166936791
"45019002701","Census Tract 27.01, Charleston County, South Carolina",2178,734,1444,0.337006427915519,0.662993572084481
"45019002702","Census Tract 27.02, Charleston County, South Carolina",5289,1152,4137,0.217810550198525,0.782189449801475
"45019002801","Census Tract 28.01, Charleston County, South Carolina",4533,3624,909,0.799470549305096,0.200529450694904
"45019002802","Census Tract 28.02, Charleston County, South Carolina",2914,2792,122,0.958133150308854,0.0418668496911462
"45019002900","Census Tract 29, Charleston County, South Carolina",2702,1879,823,0.695410806809771,0.304589193190229
"45019003000","Census Tract 30, Charleston County, South Carolina",3159,3089,70,0.9778410889522,0.0221589110478
"45019003104","Census Tract 31.04, Charleston County, South Carolina",4907,2697,2210,0.549622987568779,0.450377012431221
"45019003105","Census Tract 31.05, Charleston County, South Carolina",3888,2278,1610,0.585905349794239,0.414094650205761
"45019003106","Census Tract 31.06, Charleston County, South Carolina",6534,3381,3153,0.517447199265381,0.482552800734619
"45019003107","Census Tract 31.07, Charleston County, South Carolina",4929,1420,3509,0.28809089064719,0.71190910935281
"45019003108","Census Tract 31.08, Charleston County, South Carolina",3020,1094,1926,0.362251655629139,0.637748344370861
"45019003109","Census Tract 31.09, Charleston County, South Carolina",2953,1502,1451,0.508635286149678,0.491364713850322
"45019003110","Census Tract 31.10, Charleston County, South Carolina",6341,2859,3482,0.450875256268727,0.549124743731273
"45019003111","Census Tract 31.11, Charleston County, South Carolina",6137,1723,4414,0.280756069740916,0.719243930259084
"45019003113","Census Tract 31.13, Charleston County, South Carolina",2567,1328,1239,0.517335410985586,0.482664589014414
"45019003114","Census Tract 31.14, Charleston County, South Carolina",7433,4527,2906,0.609040764159828,0.390959235840172
"45019003115","Census Tract 31.15, Charleston County, South Carolina",7008,3728,3280,0.531963470319635,0.468036529680365
"45019003200","Census Tract 32, Charleston County, South Carolina",680,537,143,0.789705882352941,0.210294117647059
"45019003300","Census Tract 33, Charleston County, South Carolina",4110,1348,2762,0.327980535279805,0.672019464720195
"45019003400","Census Tract 34, Charleston County, South Carolina",4705,1449,3256,0.307970244420829,0.692029755579171
"45019003500","Census Tract 35, Charleston County, South Carolina",2587,2177,410,0.841515268650947,0.158484731349053
"45019003600","Census Tract 36, Charleston County, South Carolina",2619,1690,929,0.645284459717449,0.354715540282551
"45019003700","Census Tract 37, Charleston County, South Carolina",3242,501,2741,0.154534238124614,0.845465761875386
"45019003800","Census Tract 38, Charleston County, South Carolina",3283,516,2767,0.157173317088029,0.842826682911971
"45019003900","Census Tract 39, Charleston County, South Carolina",5354,2098,3256,0.391856555846096,0.608143444153904
"45019004000","Census Tract 40, Charleston County, South Carolina",2676,284,2392,0.106128550074738,0.893871449925262
"45019004300","Census Tract 43, Charleston County, South Carolina",2773,277,2496,0.0998918139199423,0.900108186080058
"45019004400","Census Tract 44, Charleston County, South Carolina",2259,276,1983,0.122177954847278,0.877822045152722
"45019004606","Census Tract 46.06, Charleston County, South Carolina",8607,7280,1327,0.845823167189497,0.154176832810503
"45019004607","Census Tract 46.07, Charleston County, South Carolina",5820,5609,211,0.963745704467354,0.036254295532646
"45019004608","Census Tract 46.08, Charleston County, South Carolina",21351,19760,1591,0.925483583907077,0.074516416092923
"45019004609","Census Tract 46.09, Charleston County, South Carolina",6221,4671,1550,0.750843915769169,0.249156084230831
"45019004610","Census Tract 46.10, Charleston County, South Carolina",2640,2282,358,0.864393939393939,0.135606060606061
"45019004611","Census Tract 46.11, Charleston County, South Carolina",8493,7612,881,0.896267514423643,0.103732485576357
"45019004612","Census Tract 46.12, Charleston County, South Carolina",6313,5787,526,0.916679866941232,0.0833201330587676
"45019004613","Census Tract 46.13, Charleston County, South Carolina",1713,1663,50,0.970811441914769,0.0291885580852306
"45019004614","Census Tract 46.14, Charleston County, South Carolina",6730,5526,1204,0.82109955423477,0.17890044576523
"45019004701","Census Tract 47.01, Charleston County, South Carolina",4991,4572,419,0.916048887998397,0.0839511120016029
"45019004702","Census Tract 47.02, Charleston County, South Carolina",2144,1829,315,0.853078358208955,0.146921641791045
"45019004800","Census Tract 48, Charleston County, South Carolina",1969,1933,36,0.981716607414931,0.0182833925850686
"45019004901","Census Tract 49.01, Charleston County, South Carolina",1945,1945,0,1,0
"45019004902","Census Tract 49.02, Charleston County, South Carolina",2272,2182,90,0.960387323943662,0.039612676056338
"45019005000","Census Tract 50, Charleston County, South Carolina",4762,1758,3004,0.369172616547669,0.630827383452331
"45019005100","Census Tract 51, Charleston County, South Carolina",1740,1315,425,0.755747126436782,0.244252873563218
"45019005200","Census Tract 52, Charleston County, South Carolina",4599,3493,1106,0.759512937595129,0.240487062404871
"45019005300","Census Tract 53, Charleston County, South Carolina",4068,899,3169,0.220993117010816,0.779006882989184
"45019005400","Census Tract 54, Charleston County, South Carolina",2115,199,1916,0.0940898345153664,0.905910165484634
"45019005500","Census Tract 55, Charleston County, South Carolina",1236,286,950,0.231391585760518,0.768608414239482
"45019005600","Census Tract 56, Charleston County, South Carolina",9575,6517,3058,0.680626631853786,0.319373368146214
"45019005700","Census Tract 57, Charleston County, South Carolina",8668,7438,1230,0.85809875403784,0.14190124596216
"45019005800","Census Tract 58, Charleston County, South Carolina",5817,4357,1460,0.749011517964587,0.250988482035413
"45021970100","Census Tract 9701, Cherokee County, South Carolina",8455,7806,649,0.923240685984624,0.0767593140153755
"45021970201","Census Tract 9702.01, Cherokee County, South Carolina",2954,1976,978,0.668923493568043,0.331076506431957
"45021970202","Census Tract 9702.02, Cherokee County, South Carolina",6752,5209,1543,0.771475118483412,0.228524881516588
"45021970301","Census Tract 9703.01, Cherokee County, South Carolina",3918,1488,2430,0.379785604900459,0.620214395099541
"45021970302","Census Tract 9703.02, Cherokee County, South Carolina",4078,2461,1617,0.603482099068171,0.396517900931829
"45021970401","Census Tract 9704.01, Cherokee County, South Carolina",3759,3329,430,0.88560787443469,0.11439212556531
"45021970402","Census Tract 9704.02, Cherokee County, South Carolina",6050,5528,522,0.913719008264463,0.0862809917355372
"45021970501","Census Tract 9705.01, Cherokee County, South Carolina",2370,1878,492,0.792405063291139,0.207594936708861
"45021970502","Census Tract 9705.02, Cherokee County, South Carolina",5076,1795,3281,0.353624901497242,0.646375098502758
"45021970503","Census Tract 9705.03, Cherokee County, South Carolina",1253,1205,48,0.961691939345571,0.0383080606544294
"45021970601","Census Tract 9706.01, Cherokee County, South Carolina",5106,4173,933,0.817273795534665,0.182726204465335
"45021970602","Census Tract 9706.02, Cherokee County, South Carolina",2361,2318,43,0.981787378229564,0.0182126217704363
"45021970700","Census Tract 9707, Cherokee County, South Carolina",3455,3166,289,0.916353111432706,0.0836468885672937
"45023020100","Census Tract 201, Chester County, South Carolina",2390,948,1442,0.396652719665272,0.603347280334728
"45023020200","Census Tract 202, Chester County, South Carolina",3104,1165,1939,0.375322164948454,0.624677835051546
"45023020300","Census Tract 203, Chester County, South Carolina",3612,855,2757,0.236710963455149,0.76328903654485
"45023020400","Census Tract 204, Chester County, South Carolina",2682,1974,708,0.736017897091723,0.263982102908277
"45023020500","Census Tract 205, Chester County, South Carolina",2728,1974,754,0.723607038123167,0.276392961876833
"45023020601","Census Tract 206.01, Chester County, South Carolina",2365,1617,748,0.683720930232558,0.316279069767442
"45023020602","Census Tract 206.02, Chester County, South Carolina",3847,2424,1423,0.630101377696907,0.369898622303093
"45023020700","Census Tract 207, Chester County, South Carolina",2040,1393,647,0.682843137254902,0.317156862745098
"45023020800","Census Tract 208, Chester County, South Carolina",5011,3827,1184,0.763719816403911,0.236280183596089
"45023020900","Census Tract 209, Chester County, South Carolina",2739,2042,697,0.745527564804673,0.254472435195327
"45023021000","Census Tract 210, Chester County, South Carolina",2361,1485,876,0.628970775095299,0.371029224904701
"45025950101","Census Tract 9501.01, Chesterfield County, South Carolina",5656,4447,1209,0.786244695898161,0.213755304101839
"45025950102","Census Tract 9501.02, Chesterfield County, South Carolina",3995,2494,1501,0.624280350438048,0.375719649561952
"45025950200","Census Tract 9502, Chesterfield County, South Carolina",4168,2750,1418,0.65978886756238,0.34021113243762
"45025950300","Census Tract 9503, Chesterfield County, South Carolina",2372,1435,937,0.604974704890388,0.395025295109612
"45025950400","Census Tract 9504, Chesterfield County, South Carolina",7145,4759,2386,0.666060181945416,0.333939818054584
"45025950501","Census Tract 9505.01, Chesterfield County, South Carolina",1921,871,1050,0.453409682457054,0.546590317542946
"45025950502","Census Tract 9505.02, Chesterfield County, South Carolina",6871,4275,2596,0.622180177557852,0.377819822442148
"45025950600","Census Tract 9506, Chesterfield County, South Carolina",6152,2676,3476,0.434980494148244,0.565019505851756
"45025950700","Census Tract 9507, Chesterfield County, South Carolina",5287,4572,715,0.864762625307358,0.135237374692642
"45025950800","Census Tract 9508, Chesterfield County, South Carolina",2885,1711,1174,0.593067590987868,0.406932409012132
"45027960100","Census Tract 9601, Clarendon County, South Carolina",3502,2620,882,0.748143917761279,0.251856082238721
"45027960201","Census Tract 9602.01, Clarendon County, South Carolina",1844,1056,788,0.572668112798265,0.427331887201735
"45027960202","Census Tract 9602.02, Clarendon County, South Carolina",1153,492,661,0.426712922810061,0.573287077189939
"45027960300","Census Tract 9603, Clarendon County, South Carolina",2018,1099,919,0.544598612487612,0.455401387512388
"45027960400","Census Tract 9604, Clarendon County, South Carolina",2313,940,1373,0.406398616515348,0.593601383484652
"45027960500","Census Tract 9605, Clarendon County, South Carolina",5369,1177,4192,0.219221456509592,0.780778543490408
"45027960600","Census Tract 9606, Clarendon County, South Carolina",2842,1450,1392,0.510204081632653,0.489795918367347
"45027960701","Census Tract 9607.01, Clarendon County, South Carolina",3944,1861,2083,0.471855983772819,0.528144016227181
"45027960702","Census Tract 9607.02, Clarendon County, South Carolina",1480,859,621,0.580405405405405,0.419594594594595
"45027960703","Census Tract 9607.03, Clarendon County, South Carolina",3539,2373,1166,0.670528397852501,0.329471602147499
"45027960801","Census Tract 9608.01, Clarendon County, South Carolina",3584,1021,2563,0.284877232142857,0.715122767857143
"45027960802","Census Tract 9608.02, Clarendon County, South Carolina",3064,1482,1582,0.483681462140992,0.516318537859008
"45029970100","Census Tract 9701, Colleton County, South Carolina",2066,881,1185,0.426427879961278,0.573572120038722
"45029970200","Census Tract 9702, Colleton County, South Carolina",1617,1075,542,0.664811379097093,0.335188620902907
"45029970300","Census Tract 9703, Colleton County, South Carolina",6278,3221,3057,0.51306148454922,0.48693851545078
"45029970401","Census Tract 9704.01, Colleton County, South Carolina",3811,2648,1163,0.69483075308318,0.30516924691682
"45029970402","Census Tract 9704.02, Colleton County, South Carolina",3415,2461,954,0.720644216691069,0.279355783308931
"45029970500","Census Tract 9705, Colleton County, South Carolina",5373,2401,2972,0.446863949376512,0.553136050623488
"45029970600","Census Tract 9706, Colleton County, South Carolina",7978,4350,3628,0.545249435948859,0.454750564051141
"45029970700","Census Tract 9707, Colleton County, South Carolina",5651,4053,1598,0.717218191470536,0.282781808529464
"45029970800","Census Tract 9708, Colleton County, South Carolina",2264,1220,1044,0.53886925795053,0.46113074204947
"45031010100","Census Tract 101, Darlington County, South Carolina",3985,1366,2619,0.342785445420326,0.657214554579674
"45031010200","Census Tract 102, Darlington County, South Carolina",5681,5288,393,0.930822038373526,0.0691779616264742
"45031010300","Census Tract 103, Darlington County, South Carolina",5286,3620,1666,0.684827847143398,0.315172152856602
"45031010400","Census Tract 104, Darlington County, South Carolina",6020,5546,474,0.921262458471761,0.0787375415282392
"45031010500","Census Tract 105, Darlington County, South Carolina",2647,1994,653,0.753305629013978,0.246694370986022
"45031010600","Census Tract 106, Darlington County, South Carolina",4870,2044,2826,0.419712525667351,0.580287474332649
"45031010700","Census Tract 107, Darlington County, South Carolina",2427,93,2334,0.03831891223733,0.96168108776267
"45031010800","Census Tract 108, Darlington County, South Carolina",2874,1363,1511,0.474251913709116,0.525748086290884
"45031010900","Census Tract 109, Darlington County, South Carolina",7371,4347,3024,0.58974358974359,0.41025641025641
"45031011000","Census Tract 110, Darlington County, South Carolina",3358,2080,1278,0.619416319237641,0.380583680762359
"45031011100","Census Tract 111, Darlington County, South Carolina",1554,977,577,0.628700128700129,0.371299871299871
"45031011200","Census Tract 112, Darlington County, South Carolina",4259,1971,2288,0.462784691242076,0.537215308757924
"45031011300","Census Tract 113, Darlington County, South Carolina",5607,2707,2900,0.48278937042982,0.51721062957018
"45031011400","Census Tract 114, Darlington County, South Carolina",4234,1023,3211,0.241615493623051,0.758384506376949
"45031011500","Census Tract 115, Darlington County, South Carolina",4812,2359,2453,0.490232751454697,0.509767248545303
"45031011600","Census Tract 116, Darlington County, South Carolina",3361,1829,1532,0.544183278786076,0.455816721213924
"45033970100","Census Tract 9701, Dillon County, South Carolina",3047,1084,1963,0.355759763702002,0.644240236297998
"45033970200","Census Tract 9702, Dillon County, South Carolina",5670,2814,2856,0.496296296296296,0.503703703703704
"45033970300","Census Tract 9703, Dillon County, South Carolina",4911,2865,2046,0.583384239462431,0.416615760537569
"45033970400","Census Tract 9704, Dillon County, South Carolina",5705,1193,4512,0.209114811568799,0.790885188431201
"45033970500","Census Tract 9705, Dillon County, South Carolina",4308,2742,1566,0.636490250696379,0.363509749303621
"45033970600","Census Tract 9706, Dillon County, South Carolina",8020,4499,3521,0.560972568578554,0.439027431421446
"45035010100","Census Tract 101, Dorchester County, South Carolina",2404,1302,1102,0.541597337770383,0.458402662229617
"45035010200","Census Tract 102, Dorchester County, South Carolina",4824,2234,2590,0.463101160862355,0.536898839137645
"45035010300","Census Tract 103, Dorchester County, South Carolina",5128,3378,1750,0.658736349453978,0.341263650546022
"45035010400","Census Tract 104, Dorchester County, South Carolina",5849,2721,3128,0.465207727816721,0.534792272183279
"45035010501","Census Tract 105.01, Dorchester County, South Carolina",4804,3379,1425,0.703372189841799,0.296627810158201
"45035010503","Census Tract 105.03, Dorchester County, South Carolina",2716,2410,306,0.887334315169367,0.112665684830633
"45035010504","Census Tract 105.04, Dorchester County, South Carolina",6509,4405,2104,0.676755261944999,0.323244738055001
"45035010505","Census Tract 105.05, Dorchester County, South Carolina",5891,4406,1485,0.747920556781531,0.252079443218469
"45035010603","Census Tract 106.03, Dorchester County, South Carolina",6330,5264,1066,0.831595576619273,0.168404423380727
"45035010604","Census Tract 106.04, Dorchester County, South Carolina",3921,3050,871,0.777862790104565,0.222137209895435
"45035010605","Census Tract 106.05, Dorchester County, South Carolina",8050,5985,2065,0.743478260869565,0.256521739130435
"45035010606","Census Tract 106.06, Dorchester County, South Carolina",1826,1489,337,0.815443592552026,0.184556407447974
"45035010700","Census Tract 107, Dorchester County, South Carolina",5306,3156,2150,0.594798341500189,0.405201658499811
"45035010801","Census Tract 108.01, Dorchester County, South Carolina",5302,4463,839,0.841757827235006,0.158242172764994
"45035010807","Census Tract 108.07, Dorchester County, South Carolina",5093,4462,631,0.876104457097978,0.123895542902022
"45035010808","Census Tract 108.08, Dorchester County, South Carolina",6640,5334,1306,0.803313253012048,0.196686746987952
"45035010809","Census Tract 108.09, Dorchester County, South Carolina",3381,2733,648,0.808340727595386,0.191659272404614
"45035010813","Census Tract 108.13, Dorchester County, South Carolina",10160,6666,3494,0.656102362204724,0.343897637795276
"45035010814","Census Tract 108.14, Dorchester County, South Carolina",6731,4770,1961,0.708661417322835,0.291338582677165
"45035010815","Census Tract 108.15, Dorchester County, South Carolina",3623,1984,1639,0.547612475848744,0.452387524151256
"45035010816","Census Tract 108.16, Dorchester County, South Carolina",11181,7097,4084,0.634737501117968,0.365262498882032
"45035010817","Census Tract 108.17, Dorchester County, South Carolina",3851,2921,930,0.758504284601402,0.241495715398598
"45035010818","Census Tract 108.18, Dorchester County, South Carolina",9318,4433,4885,0.475745868212063,0.524254131787937
"45035010819","Census Tract 108.19, Dorchester County, South Carolina",4233,3202,1031,0.756437514764942,0.243562485235058
"45035010820","Census Tract 108.20, Dorchester County, South Carolina",6731,4190,2541,0.622492943099094,0.377507056900906
"45037970201","Census Tract 9702.01, Edgefield County, South Carolina",2128,1526,602,0.717105263157895,0.282894736842105
"45037970202","Census Tract 9702.02, Edgefield County, South Carolina",7450,3447,4003,0.462684563758389,0.537315436241611
"45037970300","Census Tract 9703, Edgefield County, South Carolina",4338,2006,2332,0.462425080682342,0.537574919317658
"45037970400","Census Tract 9704, Edgefield County, South Carolina",3126,1436,1690,0.459373000639795,0.540626999360205
"45037970501","Census Tract 9705.01, Edgefield County, South Carolina",4236,2853,1383,0.673512747875354,0.326487252124646
"45037970502","Census Tract 9705.02, Edgefield County, South Carolina",5420,4558,862,0.840959409594096,0.159040590405904
"45039960100","Census Tract 9601, Fairfield County, South Carolina",1919,247,1672,0.128712871287129,0.871287128712871
"45039960200","Census Tract 9602, Fairfield County, South Carolina",3883,1640,2243,0.42235385011589,0.57764614988411
"45039960300","Census Tract 9603, Fairfield County, South Carolina",6169,3047,3122,0.493921218998217,0.506078781001783
"45039960400","Census Tract 9604, Fairfield County, South Carolina",5686,2271,3415,0.399402040098488,0.600597959901513
"45039960500","Census Tract 9605, Fairfield County, South Carolina",5932,1894,4038,0.319285232636548,0.680714767363452
"45041000101","Census Tract 1.01, Florence County, South Carolina",2648,1975,673,0.745845921450151,0.254154078549849
"45041000102","Census Tract 1.02, Florence County, South Carolina",5654,4486,1168,0.793420587194906,0.206579412805094
"45041000201","Census Tract 2.01, Florence County, South Carolina",2757,1677,1080,0.608269858541893,0.391730141458107
"45041000202","Census Tract 2.02, Florence County, South Carolina",7511,5298,2213,0.705365463986154,0.294634536013846
"45041000300","Census Tract 3, Florence County, South Carolina",4109,755,3354,0.183743003163787,0.816256996836213
"45041000400","Census Tract 4, Florence County, South Carolina",4755,2538,2217,0.533753943217666,0.466246056782334
"45041000500","Census Tract 5, Florence County, South Carolina",5578,2460,3118,0.441018286124059,0.558981713875941
"45041000600","Census Tract 6, Florence County, South Carolina",4986,3093,1893,0.620336943441637,0.379663056558363
"45041000700","Census Tract 7, Florence County, South Carolina",2898,136,2762,0.0469289164941339,0.953071083505866
"45041000800","Census Tract 8, Florence County, South Carolina",4079,85,3994,0.0208384407943123,0.979161559205688
"45041000900","Census Tract 9, Florence County, South Carolina",3381,259,3122,0.0766045548654244,0.923395445134576
"45041001000","Census Tract 10, Florence County, South Carolina",1773,1058,715,0.596728708403835,0.403271291596165
"45041001100","Census Tract 11, Florence County, South Carolina",4595,3039,1556,0.661371055495103,0.338628944504897
"45041001200","Census Tract 12, Florence County, South Carolina",3743,3419,324,0.913438418380978,0.0865615816190222
"45041001300","Census Tract 13, Florence County, South Carolina",3971,3113,858,0.78393351800554,0.21606648199446
"45041001400","Census Tract 14, Florence County, South Carolina",8120,5860,2260,0.721674876847291,0.278325123152709
"45041001503","Census Tract 15.03, Florence County, South Carolina",3542,2398,1144,0.677018633540373,0.322981366459627
"45041001504","Census Tract 15.04, Florence County, South Carolina",5341,3128,2213,0.585658116457592,0.414341883542408
"45041001505","Census Tract 15.05, Florence County, South Carolina",4331,2729,1602,0.630108519972293,0.369891480027707
"45041001506","Census Tract 15.06, Florence County, South Carolina",1483,1040,443,0.701281186783547,0.298718813216453
"45041001601","Census Tract 16.01, Florence County, South Carolina",7110,2738,4372,0.385091420534458,0.614908579465542
"45041001602","Census Tract 16.02, Florence County, South Carolina",5333,3894,1439,0.730170635664729,0.269829364335271
"45041001700","Census Tract 17, Florence County, South Carolina",2588,1385,1203,0.53516228748068,0.46483771251932
"45041001800","Census Tract 18, Florence County, South Carolina",4028,2268,1760,0.563058589870904,0.436941410129096
"45041001900","Census Tract 19, Florence County, South Carolina",6384,3955,2429,0.619517543859649,0.380482456140351
"45041002000","Census Tract 20, Florence County, South Carolina",3739,2238,1501,0.598555763573148,0.401444236426852
"45041002201","Census Tract 22.01, Florence County, South Carolina",4887,1185,3702,0.242480049109883,0.757519950890117
"45041002202","Census Tract 22.02, Florence County, South Carolina",3872,1443,2429,0.372675619834711,0.627324380165289
"45041002300","Census Tract 23, Florence County, South Carolina",3359,2762,597,0.82226853230128,0.17773146769872
"45041002400","Census Tract 24, Florence County, South Carolina",3904,2719,1185,0.696465163934426,0.303534836065574
"45041002500","Census Tract 25, Florence County, South Carolina",3126,1851,1275,0.592130518234165,0.407869481765835
"45041002600","Census Tract 26, Florence County, South Carolina",3808,1217,2591,0.319590336134454,0.680409663865546
"45043920100","Census Tract 9201, Georgetown County, South Carolina",3643,1772,1871,0.486412297556959,0.513587702443042
"45043920201","Census Tract 9202.01, Georgetown County, South Carolina",5554,2732,2822,0.491897731364782,0.508102268635218
"45043920202","Census Tract 9202.02, Georgetown County, South Carolina",2559,1629,930,0.636576787807737,0.363423212192263
"45043920301","Census Tract 9203.01, Georgetown County, South Carolina",4952,2452,2500,0.495153473344103,0.504846526655897
"45043920302","Census Tract 9203.02, Georgetown County, South Carolina",2896,2064,832,0.712707182320442,0.287292817679558
"45043920400","Census Tract 9204, Georgetown County, South Carolina",2876,558,2318,0.194019471488178,0.805980528511822
"45043920501","Census Tract 9205.01, Georgetown County, South Carolina",4941,4772,169,0.965796397490387,0.0342036025096134
"45043920502","Census Tract 9205.02, Georgetown County, South Carolina",3455,3222,233,0.932561505065123,0.067438494934877
"45043920503","Census Tract 9205.03, Georgetown County, South Carolina",5322,4459,863,0.837842916196918,0.162157083803082
"45043920504","Census Tract 9205.04, Georgetown County, South Carolina",4972,4437,535,0.892397425583266,0.107602574416734
"45043920505","Census Tract 9205.05, Georgetown County, South Carolina",3569,3415,154,0.956850658447744,0.0431493415522556
"45043920600","Census Tract 9206, Georgetown County, South Carolina",6363,1978,4385,0.310859657394311,0.689140342605689
"45043920700","Census Tract 9207, Georgetown County, South Carolina",5848,3147,2701,0.538132694938441,0.461867305061559
"45043920800","Census Tract 9208, Georgetown County, South Carolina",3330,1507,1823,0.452552552552553,0.547447447447447
"45045000100","Census Tract 1, Greenville County, South Carolina",2280,1502,778,0.658771929824561,0.341228070175439
"45045000200","Census Tract 2, Greenville County, South Carolina",964,912,52,0.946058091286307,0.053941908713693
"45045000400","Census Tract 4, Greenville County, South Carolina",1041,682,359,0.655139289145053,0.344860710854947
"45045000500","Census Tract 5, Greenville County, South Carolina",1333,232,1101,0.174043510877719,0.825956489122281
"45045000700","Census Tract 7, Greenville County, South Carolina",1674,287,1387,0.171445639187575,0.828554360812425
"45045000800","Census Tract 8, Greenville County, South Carolina",1299,225,1074,0.173210161662818,0.826789838337182
"45045000900","Census Tract 9, Greenville County, South Carolina",1240,339,901,0.273387096774194,0.726612903225806
"45045001000","Census Tract 10, Greenville County, South Carolina",2118,1671,447,0.788951841359773,0.211048158640227
"45045001101","Census Tract 11.01, Greenville County, South Carolina",3652,3436,216,0.940854326396495,0.059145673603505
"45045001102","Census Tract 11.02, Greenville County, South Carolina",1852,1659,193,0.895788336933045,0.104211663066955
"45045001203","Census Tract 12.03, Greenville County, South Carolina",3169,2756,413,0.869674976333228,0.130325023666772
"45045001204","Census Tract 12.04, Greenville County, South Carolina",2545,1744,801,0.685265225933202,0.314734774066798
"45045001205","Census Tract 12.05, Greenville County, South Carolina",1330,932,398,0.700751879699248,0.299248120300752
"45045001302","Census Tract 13.02, Greenville County, South Carolina",1489,1158,331,0.77770315648086,0.22229684351914
"45045001400","Census Tract 14, Greenville County, South Carolina",3651,3157,494,0.864694604218022,0.135305395781978
"45045001501","Census Tract 15.01, Greenville County, South Carolina",3692,3510,182,0.950704225352113,0.0492957746478874
"45045001502","Census Tract 15.02, Greenville County, South Carolina",2558,325,2233,0.127052384675528,0.872947615324472
"45045001600","Census Tract 16, Greenville County, South Carolina",4693,4280,413,0.911996590666951,0.0880034093330492
"45045001700","Census Tract 17, Greenville County, South Carolina",4242,3599,643,0.848420556341348,0.151579443658652
"45045001803","Census Tract 18.03, Greenville County, South Carolina",3929,3054,875,0.777297022143039,0.222702977856961
"45045001804","Census Tract 18.04, Greenville County, South Carolina",4084,3500,584,0.857002938295788,0.142997061704212
"45045001805","Census Tract 18.05, Greenville County, South Carolina",3905,3527,378,0.903201024327785,0.0967989756722151
"45045001807","Census Tract 18.07, Greenville County, South Carolina",5223,3898,1325,0.746314378709554,0.253685621290446
"45045001808","Census Tract 18.08, Greenville County, South Carolina",4007,2530,1477,0.631395058647367,0.368604941352633
"45045001809","Census Tract 18.09, Greenville County, South Carolina",2842,2181,661,0.767417311752287,0.232582688247713
"45045001810","Census Tract 18.10, Greenville County, South Carolina",3602,1884,1718,0.523042754025541,0.476957245974459
"45045001900","Census Tract 19, Greenville County, South Carolina",5052,4037,1015,0.799089469517023,0.200910530482977
"45045002001","Census Tract 20.01, Greenville County, South Carolina",2930,371,2559,0.126621160409556,0.873378839590444
"45045002003","Census Tract 20.03, Greenville County, South Carolina",4922,1695,3227,0.344372206420154,0.655627793579846
"45045002005","Census Tract 20.05, Greenville County, South Carolina",3784,1049,2735,0.277219873150106,0.722780126849894
"45045002103","Census Tract 21.03, Greenville County, South Carolina",3052,1720,1332,0.563564875491481,0.436435124508519
"45045002104","Census Tract 21.04, Greenville County, South Carolina",1321,679,642,0.514004542013626,0.485995457986374
"45045002105","Census Tract 21.05, Greenville County, South Carolina",2307,886,1421,0.384048547897703,0.615951452102297
"45045002106","Census Tract 21.06, Greenville County, South Carolina",3040,2159,881,0.710197368421053,0.289802631578947
"45045002107","Census Tract 21.07, Greenville County, South Carolina",3062,1847,1215,0.603200522534291,0.396799477465709
"45045002108","Census Tract 21.08, Greenville County, South Carolina",1804,852,952,0.472283813747228,0.527716186252772
"45045002201","Census Tract 22.01, Greenville County, South Carolina",6832,5237,1595,0.76653981264637,0.23346018735363
"45045002202","Census Tract 22.02, Greenville County, South Carolina",1875,1266,609,0.6752,0.3248
"45045002301","Census Tract 23.01, Greenville County, South Carolina",3853,3009,844,0.780949909161692,0.219050090838308
"45045002302","Census Tract 23.02, Greenville County, South Carolina",3453,2613,840,0.756733275412685,0.243266724587315
"45045002303","Census Tract 23.03, Greenville County, South Carolina",2078,1296,782,0.623676612127045,0.376323387872955
"45045002304","Census Tract 23.04, Greenville County, South Carolina",2488,1261,1227,0.506832797427653,0.493167202572347
"45045002402","Census Tract 24.02, Greenville County, South Carolina",7125,6681,444,0.937684210526316,0.0623157894736842
"45045002403","Census Tract 24.03, Greenville County, South Carolina",4241,4144,97,0.977128035840604,0.0228719641593964
"45045002404","Census Tract 24.04, Greenville County, South Carolina",3719,3656,63,0.983059962355472,0.0169400376445281
"45045002503","Census Tract 25.03, Greenville County, South Carolina",9471,7895,1576,0.833597297011931,0.166402702988069
"45045002504","Census Tract 25.04, Greenville County, South Carolina",1770,1247,523,0.704519774011299,0.295480225988701
"45045002505","Census Tract 25.05, Greenville County, South Carolina",3580,2797,783,0.781284916201117,0.218715083798883
"45045002506","Census Tract 25.06, Greenville County, South Carolina",3713,3336,377,0.898464853218422,0.101535146781578
"45045002507","Census Tract 25.07, Greenville County, South Carolina",5019,4250,769,0.846782227535366,0.153217772464634
"45045002602","Census Tract 26.02, Greenville County, South Carolina",3656,3218,438,0.88019693654267,0.11980306345733
"45045002604","Census Tract 26.04, Greenville County, South Carolina",5278,4049,1229,0.767146646456991,0.232853353543009
"45045002606","Census Tract 26.06, Greenville County, South Carolina",5617,5365,252,0.955136193697703,0.0448638063022966
"45045002608","Census Tract 26.08, Greenville County, South Carolina",9367,8128,1239,0.8677271271485,0.1322728728515
"45045002609","Census Tract 26.09, Greenville County, South Carolina",6415,5603,812,0.873421667965705,0.126578332034295
"45045002610","Census Tract 26.10, Greenville County, South Carolina",2965,1985,980,0.669477234401349,0.330522765598651
"45045002611","Census Tract 26.11, Greenville County, South Carolina",5319,3963,1356,0.745064861816131,0.254935138183869
"45045002701","Census Tract 27.01, Greenville County, South Carolina",4252,4158,94,0.977892756349953,0.022107243650047
"45045002702","Census Tract 27.02, Greenville County, South Carolina",8114,7162,952,0.882671925067784,0.117328074932216
"45045002803","Census Tract 28.03, Greenville County, South Carolina",7879,6616,1263,0.839700469602741,0.160299530397259
"45045002804","Census Tract 28.04, Greenville County, South Carolina",2362,2273,89,0.962320067739204,0.0376799322607959
"45045002805","Census Tract 28.05, Greenville County, South Carolina",4476,3931,545,0.878239499553172,0.121760500446828
"45045002808","Census Tract 28.08, Greenville County, South Carolina",6422,4912,1510,0.764870756773591,0.235129243226409
"45045002811","Census Tract 28.11, Greenville County, South Carolina",7532,5776,1756,0.766861391396707,0.233138608603293
"45045002812","Census Tract 28.12, Greenville County, South Carolina",7510,6466,1044,0.860985352862849,0.139014647137151
"45045002813","Census Tract 28.13, Greenville County, South Carolina",4409,3743,666,0.848945339079156,0.151054660920844
"45045002814","Census Tract 28.14, Greenville County, South Carolina",5766,4904,862,0.850502948317725,0.149497051682275
"45045002815","Census Tract 28.15, Greenville County, South Carolina",5931,5112,819,0.861911987860395,0.138088012139605
"45045002816","Census Tract 28.16, Greenville County, South Carolina",8929,7434,1495,0.832568036734237,0.167431963265763
"45045002901","Census Tract 29.01, Greenville County, South Carolina",4777,2423,2354,0.50722210592422,0.49277789407578
"45045002903","Census Tract 29.03, Greenville County, South Carolina",6470,4525,1945,0.699381761978362,0.300618238021638
"45045002904","Census Tract 29.04, Greenville County, South Carolina",5316,3215,2101,0.604778028592927,0.395221971407073
"45045002905","Census Tract 29.05, Greenville County, South Carolina",4542,3183,1359,0.700792602377807,0.299207397622193
"45045003005","Census Tract 30.05, Greenville County, South Carolina",2367,1916,451,0.809463455851289,0.190536544148711
"45045003008","Census Tract 30.08, Greenville County, South Carolina",6958,5875,1083,0.844351825237137,0.155648174762863
"45045003009","Census Tract 30.09, Greenville County, South Carolina",5313,4832,481,0.909467344249953,0.0905326557500471
"45045003010","Census Tract 30.10, Greenville County, South Carolina",6045,4786,1259,0.791728701406121,0.208271298593879
"45045003011","Census Tract 30.11, Greenville County, South Carolina",5265,4209,1056,0.799430199430199,0.200569800569801
"45045003012","Census Tract 30.12, Greenville County, South Carolina",5384,4188,1196,0.777860326894502,0.222139673105498
"45045003013","Census Tract 30.13, Greenville County, South Carolina",6238,4256,1982,0.682269958319974,0.317730041680026
"45045003014","Census Tract 30.14, Greenville County, South Carolina",4372,3514,858,0.803751143641354,0.196248856358646
"45045003015","Census Tract 30.15, Greenville County, South Carolina",8153,7117,1036,0.872930209738746,0.127069790261254
"45045003101","Census Tract 31.01, Greenville County, South Carolina",6644,4655,1989,0.700632149307646,0.299367850692354
"45045003103","Census Tract 31.03, Greenville County, South Carolina",3131,2910,221,0.929415522197381,0.070584477802619
"45045003104","Census Tract 31.04, Greenville County, South Carolina",2107,2030,77,0.963455149501661,0.0365448504983389
"45045003201","Census Tract 32.01, Greenville County, South Carolina",5304,3841,1463,0.724170437405732,0.275829562594268
"45045003202","Census Tract 32.02, Greenville County, South Carolina",3578,3250,328,0.908328675237563,0.0916713247624371
"45045003301","Census Tract 33.01, Greenville County, South Carolina",5353,4015,1338,0.750046702783486,0.249953297216514
"45045003303","Census Tract 33.03, Greenville County, South Carolina",4853,3477,1376,0.716464042860087,0.283535957139913
"45045003304","Census Tract 33.04, Greenville County, South Carolina",6191,4112,2079,0.66418995315781,0.33581004684219
"45045003401","Census Tract 34.01, Greenville County, South Carolina",1021,454,567,0.444662095984329,0.555337904015671
"45045003500","Census Tract 35, Greenville County, South Carolina",2396,1418,978,0.591819699499165,0.408180300500835
"45045003601","Census Tract 36.01, Greenville County, South Carolina",5734,3774,1960,0.658179281478898,0.341820718521102
"45045003602","Census Tract 36.02, Greenville County, South Carolina",2673,1163,1510,0.43509165731388,0.56490834268612
"45045003701","Census Tract 37.01, Greenville County, South Carolina",5275,4347,928,0.824075829383886,0.175924170616114
"45045003704","Census Tract 37.04, Greenville County, South Carolina",3606,2647,959,0.734054353854687,0.265945646145313
"45045003705","Census Tract 37.05, Greenville County, South Carolina",1582,1164,418,0.735777496839444,0.264222503160556
"45045003706","Census Tract 37.06, Greenville County, South Carolina",3370,2025,1345,0.600890207715134,0.399109792284866
"45045003707","Census Tract 37.07, Greenville County, South Carolina",3769,2897,872,0.768638896258955,0.231361103741045
"45045003801","Census Tract 38.01, Greenville County, South Carolina",6912,6227,685,0.900896990740741,0.0991030092592593
"45045003802","Census Tract 38.02, Greenville County, South Carolina",4740,3748,992,0.790717299578059,0.209282700421941
"45045003902","Census Tract 39.02, Greenville County, South Carolina",3214,2916,298,0.907280647168637,0.0927193528313628
"45045003903","Census Tract 39.03, Greenville County, South Carolina",4050,3800,250,0.938271604938272,0.0617283950617284
"45045003904","Census Tract 39.04, Greenville County, South Carolina",6484,5207,1277,0.80305367057372,0.19694632942628
"45045004001","Census Tract 40.01, Greenville County, South Carolina",3162,3029,133,0.957938013915243,0.0420619860847565
"45045004002","Census Tract 40.02, Greenville County, South Carolina",5362,5049,313,0.941626258858635,0.0583737411413652
"45045004101","Census Tract 41.01, Greenville County, South Carolina",3480,3199,281,0.919252873563218,0.0807471264367816
"45045004102","Census Tract 41.02, Greenville County, South Carolina",1231,1199,32,0.974004874086109,0.0259951259138912
"45045004200","Census Tract 42, Greenville County, South Carolina",2611,2200,411,0.842589046342398,0.157410953657602
"45045004300","Census Tract 43, Greenville County, South Carolina",3483,378,3105,0.108527131782946,0.891472868217054
"45045004400","Census Tract 44, Greenville County, South Carolina",2237,1112,1125,0.497094322753688,0.502905677246312
"45047970101","Census Tract 9701.01, Greenwood County, South Carolina",3812,2574,1238,0.675236096537251,0.324763903462749
"45047970102","Census Tract 9701.02, Greenwood County, South Carolina",4311,3118,1193,0.723266063558339,0.276733936441661
"45047970201","Census Tract 9702.01, Greenwood County, South Carolina",3956,3008,948,0.760364004044489,0.239635995955511
"45047970202","Census Tract 9702.02, Greenwood County, South Carolina",8724,6154,2570,0.705410362219166,0.294589637780834
"45047970301","Census Tract 9703.01, Greenwood County, South Carolina",4484,3412,1072,0.76092774308653,0.23907225691347
"45047970302","Census Tract 9703.02, Greenwood County, South Carolina",5639,4501,1138,0.798191168646923,0.201808831353077
"45047970400","Census Tract 9704, Greenwood County, South Carolina",6829,5093,1736,0.745790013179089,0.254209986820911
"45047970500","Census Tract 9705, Greenwood County, South Carolina",4737,1097,3640,0.231581169516572,0.768418830483428
"45047970600","Census Tract 9706, Greenwood County, South Carolina",6780,3833,2947,0.565339233038348,0.434660766961652
"45047970701","Census Tract 9707.01, Greenwood County, South Carolina",2177,1749,428,0.803399173174093,0.196600826825907
"45047970702","Census Tract 9707.02, Greenwood County, South Carolina",5360,3205,2155,0.59794776119403,0.40205223880597
"45047970800","Census Tract 9708, Greenwood County, South Carolina",8763,3697,5066,0.421887481456122,0.578112518543878
"45047970900","Census Tract 9709, Greenwood County, South Carolina",2233,1453,780,0.650694133452754,0.349305866547246
"45047971000","Census Tract 9710, Greenwood County, South Carolina",1922,1718,204,0.893860561914672,0.106139438085328
"45049920100","Census Tract 9201, Hampton County, South Carolina",2532,1820,712,0.718799368088468,0.281200631911532
"45049920200","Census Tract 9202, Hampton County, South Carolina",7383,2918,4465,0.395232290396858,0.604767709603142
"45049920300","Census Tract 9203, Hampton County, South Carolina",2050,802,1248,0.391219512195122,0.608780487804878
"45049920400","Census Tract 9204, Hampton County, South Carolina",7151,3027,4124,0.423297440917354,0.576702559082646
"45049920500","Census Tract 9205, Hampton County, South Carolina",1724,334,1390,0.193735498839907,0.806264501160093
"45051010100","Census Tract 101, Horry County, South Carolina",2690,2198,492,0.817100371747212,0.182899628252788
"45051020100","Census Tract 201, Horry County, South Carolina",3318,2406,912,0.725135623869801,0.274864376130199
"45051020200","Census Tract 202, Horry County, South Carolina",5160,2873,2287,0.556782945736434,0.443217054263566
"45051020300","Census Tract 203, Horry County, South Carolina",7170,5504,1666,0.767642956764296,0.232357043235704
"45051030101","Census Tract 301.01, Horry County, South Carolina",1163,310,853,0.266552020636285,0.733447979363715
"45051030102","Census Tract 301.02, Horry County, South Carolina",2994,2376,618,0.793587174348697,0.206412825651303
"45051030103","Census Tract 301.03, Horry County, South Carolina",3348,2117,1231,0.63231780167264,0.36768219832736
"45051040101","Census Tract 401.01, Horry County, South Carolina",4611,3583,1028,0.777054868792019,0.222945131207981
"45051040102","Census Tract 401.02, Horry County, South Carolina",4900,3563,1337,0.727142857142857,0.272857142857143
"45051040103","Census Tract 401.03, Horry County, South Carolina",5224,4361,863,0.834800918836141,0.165199081163859
"45051040104","Census Tract 401.04, Horry County, South Carolina",2912,2688,224,0.923076923076923,0.0769230769230769
"45051040105","Census Tract 401.05, Horry County, South Carolina",2476,2251,225,0.909127625201939,0.0908723747980614
"45051040200","Census Tract 402, Horry County, South Carolina",3423,3081,342,0.900087642418931,0.0999123575810692
"45051040300","Census Tract 403, Horry County, South Carolina",3917,3643,274,0.930048506510084,0.0699514934899158
"45051040400","Census Tract 404, Horry County, South Carolina",4084,3860,224,0.945151811949069,0.0548481880509305
"45051040500","Census Tract 405, Horry County, South Carolina",3530,3044,486,0.862322946175637,0.137677053824363
"45051050102","Census Tract 501.02, Horry County, South Carolina",3432,3222,210,0.938811188811189,0.0611888111888111
"45051050200","Census Tract 502, Horry County, South Carolina",1418,1368,50,0.964739069111425,0.0352609308885754
"45051050303","Census Tract 503.03, Horry County, South Carolina",2296,2242,54,0.976480836236934,0.0235191637630662
"45051050401","Census Tract 504.01, Horry County, South Carolina",2412,2193,219,0.909203980099503,0.0907960199004975
"45051050402","Census Tract 504.02, Horry County, South Carolina",1845,1838,7,0.996205962059621,0.00379403794037936
"45051050500","Census Tract 505, Horry County, South Carolina",4386,3989,397,0.909484724122207,0.090515275877793
"45051050600","Census Tract 506, Horry County, South Carolina",4464,1559,2905,0.34923835125448,0.65076164874552
"45051050700","Census Tract 507, Horry County, South Carolina",1716,1330,386,0.775058275058275,0.224941724941725
"45051050900","Census Tract 509, Horry County, South Carolina",6644,4445,2199,0.669024683925346,0.330975316074654
"45051051000","Census Tract 510, Horry County, South Carolina",2706,2448,258,0.904656319290466,0.0953436807095344
"45051051201","Census Tract 512.01, Horry County, South Carolina",1557,1540,17,0.989081567116249,0.0109184328837508
"45051051202","Census Tract 512.02, Horry County, South Carolina",2295,2085,210,0.908496732026144,0.0915032679738562
"45051051301","Census Tract 513.01, Horry County, South Carolina",991,962,29,0.970736629667003,0.029263370332997
"45051051302","Census Tract 513.02, Horry County, South Carolina",3075,3075,0,1,0
"45051051403","Census Tract 514.03, Horry County, South Carolina",4556,4171,385,0.915496049165935,0.0845039508340649
"45051051404","Census Tract 514.04, Horry County, South Carolina",3412,3229,183,0.946365767878077,0.0536342321219226
"45051051405","Census Tract 514.05, Horry County, South Carolina",3309,3193,116,0.964944091870656,0.0350559081293442
"45051051406","Census Tract 514.06, Horry County, South Carolina",3062,2894,168,0.945133899412149,0.0548661005878511
"45051051501","Census Tract 515.01, Horry County, South Carolina",3577,2764,813,0.772714565278166,0.227285434721834
"45051051502","Census Tract 515.02, Horry County, South Carolina",7768,7034,734,0.905509783728115,0.0944902162718847
"45051051503","Census Tract 515.03, Horry County, South Carolina",3637,2515,1122,0.69150398680231,0.30849601319769
"45051051601","Census Tract 516.01, Horry County, South Carolina",8740,6632,2108,0.758810068649886,0.241189931350114
"45051051603","Census Tract 516.03, Horry County, South Carolina",3898,3521,377,0.903283735248846,0.0967162647511545
"45051051604","Census Tract 516.04, Horry County, South Carolina",7729,7550,179,0.976840470953552,0.0231595290464485
"45051051605","Census Tract 516.05, Horry County, South Carolina",5310,4683,627,0.881920903954802,0.118079096045198
"45051051700","Census Tract 517, Horry County, South Carolina",2170,1744,426,0.8036866359447,0.1963133640553
"45051060101","Census Tract 601.01, Horry County, South Carolina",3358,2571,787,0.765634306134604,0.234365693865396
"45051060102","Census Tract 601.02, Horry County, South Carolina",3054,2231,823,0.730517354289456,0.269482645710544
"45051060203","Census Tract 602.03, Horry County, South Carolina",5397,4365,1032,0.808782657031684,0.191217342968316
"45051060204","Census Tract 602.04, Horry County, South Carolina",7788,6668,1120,0.856189008731382,0.143810991268618
"45051060206","Census Tract 602.06, Horry County, South Carolina",6298,5849,449,0.928707526198793,0.0712924738012067
"45051060207","Census Tract 602.07, Horry County, South Carolina",4549,4260,289,0.936469553748076,0.0635304462519235
"45051060208","Census Tract 602.08, Horry County, South Carolina",2522,2150,372,0.852498017446471,0.147501982553529
"45051060209","Census Tract 602.09, Horry County, South Carolina",6016,5009,1007,0.832613031914894,0.167386968085106
"45051060301","Census Tract 603.01, Horry County, South Carolina",3702,3017,685,0.814964883846569,0.185035116153431
"45051060303","Census Tract 603.03, Horry County, South Carolina",1910,1758,152,0.920418848167539,0.0795811518324607
"45051060308","Census Tract 603.08, Horry County, South Carolina",5368,3458,1910,0.644187779433681,0.355812220566319
"45051060403","Census Tract 604.03, Horry County, South Carolina",2590,2134,456,0.823938223938224,0.176061776061776
"45051060404","Census Tract 604.04, Horry County, South Carolina",1491,1344,147,0.901408450704225,0.0985915492957746
"45051060405","Census Tract 604.05, Horry County, South Carolina",6169,4778,1391,0.774517750040525,0.225482249959475
"45051060406","Census Tract 604.06, Horry County, South Carolina",6090,5539,551,0.90952380952381,0.0904761904761905
"45051070101","Census Tract 701.01, Horry County, South Carolina",4410,3736,674,0.847165532879819,0.152834467120181
"45051070102","Census Tract 701.02, Horry County, South Carolina",3396,2788,608,0.820965842167256,0.179034157832744
"45051070200","Census Tract 702, Horry County, South Carolina",3221,2475,746,0.768394908413536,0.231605091586464
"45051070300","Census Tract 703, Horry County, South Carolina",3435,1695,1740,0.493449781659389,0.506550218340611
"45051070400","Census Tract 704, Horry County, South Carolina",5063,1487,3576,0.293699387714794,0.706300612285206
"45051070500","Census Tract 705, Horry County, South Carolina",3554,1793,1761,0.504501969611705,0.495498030388295
"45051070601","Census Tract 706.01, Horry County, South Carolina",4777,3875,902,0.811178563952271,0.188821436047729
"45051070602","Census Tract 706.02, Horry County, South Carolina",4830,2796,2034,0.57888198757764,0.42111801242236
"45051070701","Census Tract 707.01, Horry County, South Carolina",4989,3849,1140,0.771497294046903,0.228502705953097
"45051070702","Census Tract 707.02, Horry County, South Carolina",5003,3440,1563,0.687587447531481,0.312412552468519
"45051080101","Census Tract 801.01, Horry County, South Carolina",3437,2928,509,0.851905731742799,0.148094268257201
"45051080102","Census Tract 801.02, Horry County, South Carolina",2447,2107,340,0.861054352268083,0.138945647731917
"45051080200","Census Tract 802, Horry County, South Carolina",4457,4157,300,0.932690150325331,0.067309849674669
"45051980100","Census Tract 9801, Horry County, South Carolina",42,42,0,1,0
"45053950100","Census Tract 9501, Jasper County, South Carolina",5645,2703,2942,0.478830823737821,0.521169176262179
"45053950201","Census Tract 9502.01, Jasper County, South Carolina",3861,2138,1723,0.553742553742554,0.446257446257446
"45053950202","Census Tract 9502.02, Jasper County, South Carolina",8392,2910,5482,0.34675881792183,0.65324118207817
"45053950300","Census Tract 9503, Jasper County, South Carolina",7510,3621,3889,0.482157123834887,0.517842876165113
"45055970100","Census Tract 9701, Kershaw County, South Carolina",2538,1671,867,0.65839243498818,0.34160756501182
"45055970200","Census Tract 9702, Kershaw County, South Carolina",3249,2450,799,0.754078177900893,0.245921822099107
"45055970300","Census Tract 9703, Kershaw County, South Carolina",2315,1472,843,0.63585313174946,0.36414686825054
"45055970401","Census Tract 9704.01, Kershaw County, South Carolina",4422,3792,630,0.85753052917232,0.14246947082768
"45055970402","Census Tract 9704.02, Kershaw County, South Carolina",2357,1701,656,0.721680101824353,0.278319898175647
"45055970403","Census Tract 9704.03, Kershaw County, South Carolina",2361,1926,435,0.815756035578145,0.184243964421855
"45055970500","Census Tract 9705, Kershaw County, South Carolina",5516,3553,1963,0.644126178390138,0.355873821609862
"45055970601","Census Tract 9706.01, Kershaw County, South Carolina",5240,3828,1412,0.730534351145038,0.269465648854962
"45055970602","Census Tract 9706.02, Kershaw County, South Carolina",4654,3275,1379,0.703695745595187,0.296304254404813
"45055970700","Census Tract 9707, Kershaw County, South Carolina",2857,1872,985,0.655232761638082,0.344767238361918
"45055970800","Census Tract 9708, Kershaw County, South Carolina",6758,3482,3276,0.515241195620006,0.484758804379994
"45055970902","Census Tract 9709.02, Kershaw County, South Carolina",3011,2117,894,0.703088674858851,0.296911325141149
"45055970903","Census Tract 9709.03, Kershaw County, South Carolina",6062,5315,747,0.87677334213131,0.12322665786869
"45055970904","Census Tract 9709.04, Kershaw County, South Carolina",7870,5407,2463,0.687039390088945,0.312960609911055
"45055970905","Census Tract 9709.05, Kershaw County, South Carolina",2708,2313,395,0.854135893648449,0.145864106351551
"45057010100","Census Tract 101, Lancaster County, South Carolina",3956,3716,240,0.939332659251769,0.0606673407482305
"45057010200","Census Tract 102, Lancaster County, South Carolina",7877,5640,2237,0.716008632728196,0.283991367271804
"45057010300","Census Tract 103, Lancaster County, South Carolina",5488,3921,1567,0.714467930029155,0.285532069970845
"45057010400","Census Tract 104, Lancaster County, South Carolina",2846,1568,1278,0.550948699929726,0.449051300070274
"45057010500","Census Tract 105, Lancaster County, South Carolina",6066,3419,2647,0.563633366303989,0.436366633696011
"45057010600","Census Tract 106, Lancaster County, South Carolina",5243,3742,1501,0.713713522792294,0.286286477207706
"45057010700","Census Tract 107, Lancaster County, South Carolina",3878,675,3203,0.174058793192367,0.825941206807633
"45057010800","Census Tract 108, Lancaster County, South Carolina",3000,1663,1337,0.554333333333333,0.445666666666667
"45057010900","Census Tract 109, Lancaster County, South Carolina",3807,2826,981,0.742316784869976,0.257683215130024
"45057011001","Census Tract 110.01, Lancaster County, South Carolina",5198,4342,856,0.83532127741439,0.16467872258561
"45057011002","Census Tract 110.02, Lancaster County, South Carolina",4463,3651,812,0.818059601165136,0.181940398834864
"45057011100","Census Tract 111, Lancaster County, South Carolina",5787,3868,1919,0.668394677725937,0.331605322274063
"45057011201","Census Tract 112.01, Lancaster County, South Carolina",9413,8370,1043,0.889195793052162,0.110804206947838
"45057011202","Census Tract 112.02, Lancaster County, South Carolina",10924,10062,862,0.921091175393629,0.0789088246063713
"45059920101","Census Tract 9201.01, Laurens County, South Carolina",6575,4753,1822,0.722889733840304,0.277110266159696
"45059920102","Census Tract 9201.02, Laurens County, South Carolina",1814,1659,155,0.914553472987872,0.0854465270121278
"45059920103","Census Tract 9201.03, Laurens County, South Carolina",4625,3589,1036,0.776,0.224
"45059920104","Census Tract 9201.04, Laurens County, South Carolina",3213,2684,529,0.835356364768129,0.164643635231871
"45059920201","Census Tract 9202.01, Laurens County, South Carolina",3303,2835,468,0.858310626702997,0.141689373297003
"45059920202","Census Tract 9202.02, Laurens County, South Carolina",3912,3882,30,0.992331288343558,0.00766871165644167
"45059920301","Census Tract 9203.01, Laurens County, South Carolina",3911,2848,1063,0.728202505753004,0.271797494246996
"45059920302","Census Tract 9203.02, Laurens County, South Carolina",4208,2332,1876,0.554182509505703,0.445817490494297
"45059920400","Census Tract 9204, Laurens County, South Carolina",5337,3404,1933,0.637811504590594,0.362188495409406
"45059920501","Census Tract 9205.01, Laurens County, South Carolina",1659,1209,450,0.72875226039783,0.27124773960217
"45059920502","Census Tract 9205.02, Laurens County, South Carolina",5830,3541,2289,0.6073756432247,0.3926243567753
"45059920600","Census Tract 9206, Laurens County, South Carolina",4634,2824,1810,0.609408718170047,0.390591281829953
"45059920700","Census Tract 9207, Laurens County, South Carolina",4492,1919,2573,0.427203918076581,0.572796081923419
"45059920800","Census Tract 9208, Laurens County, South Carolina",5256,4096,1160,0.779299847792998,0.220700152207002
"45059920900","Census Tract 9209, Laurens County, South Carolina",2276,1735,541,0.762302284710018,0.237697715289982
"45059921001","Census Tract 9210.01, Laurens County, South Carolina",2634,1699,935,0.645026575550494,0.354973424449506
"45059921002","Census Tract 9210.02, Laurens County, South Carolina",2778,2205,573,0.793736501079914,0.206263498920086
"45061920100","Census Tract 9201, Lee County, South Carolina",1766,1069,697,0.605322763306908,0.394677236693092
"45061920200","Census Tract 9202, Lee County, South Carolina",4436,2080,2356,0.468890892696123,0.531109107303877
"45061920302","Census Tract 9203.02, Lee County, South Carolina",5171,968,4203,0.187197834074647,0.812802165925353
"45061920400","Census Tract 9204, Lee County, South Carolina",4391,1478,2913,0.336597585971305,0.663402414028695
"45061920500","Census Tract 9205, Lee County, South Carolina",1643,376,1267,0.2288496652465,0.7711503347535
"45061920600","Census Tract 9206, Lee County, South Carolina",1483,277,1206,0.186783546864464,0.813216453135536
"45063020100","Census Tract 201, Lexington County, South Carolina",2463,1893,570,0.76857490864799,0.23142509135201
"45063020201","Census Tract 202.01, Lexington County, South Carolina",2866,2383,483,0.831472435450105,0.168527564549895
"45063020202","Census Tract 202.02, Lexington County, South Carolina",2199,1437,762,0.653478854024557,0.346521145975443
"45063020300","Census Tract 203, Lexington County, South Carolina",4549,3547,1002,0.779731809188833,0.220268190811167
"45063020505","Census Tract 205.05, Lexington County, South Carolina",3864,3078,786,0.796583850931677,0.203416149068323
"45063020506","Census Tract 205.06, Lexington County, South Carolina",3752,3164,588,0.843283582089552,0.156716417910448
"45063020507","Census Tract 205.07, Lexington County, South Carolina",6603,5169,1434,0.782825988187188,0.217174011812812
"45063020508","Census Tract 205.08, Lexington County, South Carolina",2355,2242,113,0.952016985138004,0.0479830148619957
"45063020509","Census Tract 205.09, Lexington County, South Carolina",3208,2032,1176,0.633416458852868,0.366583541147132
"45063020510","Census Tract 205.10, Lexington County, South Carolina",4914,2646,2268,0.538461538461538,0.461538461538462
"45063020511","Census Tract 205.11, Lexington County, South Carolina",3379,1616,1763,0.478248002367564,0.521751997632436
"45063020601","Census Tract 206.01, Lexington County, South Carolina",4071,2925,1146,0.718496683861459,0.281503316138541
"45063020602","Census Tract 206.02, Lexington County, South Carolina",3976,3375,601,0.848843058350101,0.151156941649899
"45063020604","Census Tract 206.04, Lexington County, South Carolina",3429,2916,513,0.850393700787402,0.149606299212598
"45063020605","Census Tract 206.05, Lexington County, South Carolina",1783,1508,275,0.845765563656758,0.154234436343242
"45063020703","Census Tract 207.03, Lexington County, South Carolina",4076,3680,396,0.902845927379784,0.0971540726202159
"45063020705","Census Tract 207.05, Lexington County, South Carolina",3807,2434,1373,0.639348568426583,0.360651431573417
"45063020706","Census Tract 207.06, Lexington County, South Carolina",3128,1449,1679,0.463235294117647,0.536764705882353
"45063020707","Census Tract 207.07, Lexington County, South Carolina",3814,2575,1239,0.675144205558469,0.324855794441531
"45063020708","Census Tract 207.08, Lexington County, South Carolina",2703,2538,165,0.938956714761376,0.0610432852386238
"45063020801","Census Tract 208.01, Lexington County, South Carolina",1512,1319,193,0.872354497354497,0.127645502645503
"45063020802","Census Tract 208.02, Lexington County, South Carolina",2563,1893,670,0.738587592664846,0.261412407335154
"45063020803","Census Tract 208.03, Lexington County, South Carolina",3417,2088,1329,0.611062335381914,0.388937664618086
"45063020804","Census Tract 208.04, Lexington County, South Carolina",2762,2051,711,0.742577842143374,0.257422157856626
"45063020805","Census Tract 208.05, Lexington County, South Carolina",5623,4368,1255,0.776809532278143,0.223190467721857
"45063020903","Census Tract 209.03, Lexington County, South Carolina",4779,4530,249,0.947897049591965,0.0521029504080351
"45063020904","Census Tract 209.04, Lexington County, South Carolina",3164,2658,506,0.84007585335019,0.15992414664981
"45063020905","Census Tract 209.05, Lexington County, South Carolina",3687,3047,640,0.826417141307296,0.173582858692704
"45063020906","Census Tract 209.06, Lexington County, South Carolina",3922,3802,120,0.969403365629781,0.0305966343702193
"45063020907","Census Tract 209.07, Lexington County, South Carolina",6037,4564,1473,0.756004638065264,0.243995361934736
"45063020908","Census Tract 209.08, Lexington County, South Carolina",3006,2500,506,0.83166999334664,0.16833000665336
"45063021009","Census Tract 210.09, Lexington County, South Carolina",8670,7318,1352,0.844059976931949,0.155940023068051
"45063021014","Census Tract 210.14, Lexington County, South Carolina",5447,4473,974,0.821185973930604,0.178814026069396
"45063021017","Census Tract 210.17, Lexington County, South Carolina",7847,6950,897,0.885688798266854,0.114311201733146
"45063021018","Census Tract 210.18, Lexington County, South Carolina",4830,4572,258,0.946583850931677,0.0534161490683229
"45063021019","Census Tract 210.19, Lexington County, South Carolina",1565,1378,187,0.880511182108626,0.119488817891374
"45063021020","Census Tract 210.20, Lexington County, South Carolina",3579,2935,644,0.820061469684269,0.179938530315731
"45063021021","Census Tract 210.21, Lexington County, South Carolina",1530,1457,73,0.952287581699346,0.0477124183006536
"45063021022","Census Tract 210.22, Lexington County, South Carolina",3771,3346,425,0.88729779899231,0.11270220100769
"45063021023","Census Tract 210.23, Lexington County, South Carolina",2625,2392,233,0.911238095238095,0.0887619047619047
"45063021024","Census Tract 210.24, Lexington County, South Carolina",4000,3678,322,0.9195,0.0805
"45063021025","Census Tract 210.25, Lexington County, South Carolina",3294,3260,34,0.989678202792957,0.0103217972070431
"45063021026","Census Tract 210.26, Lexington County, South Carolina",4372,4268,104,0.976212259835316,0.0237877401646843
"45063021027","Census Tract 210.27, Lexington County, South Carolina",4168,3574,594,0.857485604606526,0.142514395393474
"45063021028","Census Tract 210.28, Lexington County, South Carolina",3482,2555,927,0.733773693279724,0.266226306720276
"45063021029","Census Tract 210.29, Lexington County, South Carolina",3958,2665,1293,0.673319858514401,0.326680141485599
"45063021030","Census Tract 210.30, Lexington County, South Carolina",4490,3830,660,0.853006681514477,0.146993318485523
"45063021031","Census Tract 210.31, Lexington County, South Carolina",3977,3546,431,0.891626854412874,0.108373145587126
"45063021032","Census Tract 210.32, Lexington County, South Carolina",3618,3487,131,0.963792150359315,0.0362078496406855
"45063021033","Census Tract 210.33, Lexington County, South Carolina",4521,3399,1122,0.751824817518248,0.248175182481752
"45063021034","Census Tract 210.34, Lexington County, South Carolina",4529,3527,1002,0.778759107970854,0.221240892029146
"45063021106","Census Tract 211.06, Lexington County, South Carolina",2967,2606,361,0.878328277721604,0.121671722278396
"45063021109","Census Tract 211.09, Lexington County, South Carolina",3377,2309,1068,0.683742967130589,0.316257032869411
"45063021110","Census Tract 211.10, Lexington County, South Carolina",3196,2574,622,0.805381727158949,0.194618272841051
"45063021111","Census Tract 211.11, Lexington County, South Carolina",2433,1511,922,0.621043978627209,0.378956021372791
"45063021112","Census Tract 211.12, Lexington County, South Carolina",3250,2766,484,0.851076923076923,0.148923076923077
"45063021113","Census Tract 211.13, Lexington County, South Carolina",3124,1920,1204,0.614596670934699,0.385403329065301
"45063021114","Census Tract 211.14, Lexington County, South Carolina",3765,3040,725,0.807436918990704,0.192563081009296
"45063021115","Census Tract 211.15, Lexington County, South Carolina",2116,1957,159,0.924858223062382,0.0751417769376181
"45063021116","Census Tract 211.16, Lexington County, South Carolina",3276,2364,912,0.721611721611722,0.278388278388278
"45063021203","Census Tract 212.03, Lexington County, South Carolina",5048,4754,294,0.94175911251981,0.0582408874801902
"45063021204","Census Tract 212.04, Lexington County, South Carolina",3386,3037,349,0.896928529238039,0.103071470761961
"45063021205","Census Tract 212.05, Lexington County, South Carolina",3057,2908,149,0.951259404645077,0.0487405953549231
"45063021206","Census Tract 212.06, Lexington County, South Carolina",2903,2491,412,0.858077850499483,0.141922149500517
"45063021303","Census Tract 213.03, Lexington County, South Carolina",2859,2858,1,0.999650227352221,0.000349772647778912
"45063021304","Census Tract 213.04, Lexington County, South Carolina",4163,3852,311,0.925294258947874,0.0747057410521259
"45063021305","Census Tract 213.05, Lexington County, South Carolina",2825,2457,368,0.869734513274336,0.130265486725664
"45063021306","Census Tract 213.06, Lexington County, South Carolina",3861,3432,429,0.888888888888889,0.111111111111111
"45063021307","Census Tract 213.07, Lexington County, South Carolina",1789,1555,234,0.869200670765791,0.130799329234209
"45063021308","Census Tract 213.08, Lexington County, South Carolina",4479,3349,1130,0.747711542755079,0.252288457244921
"45063021402","Census Tract 214.02, Lexington County, South Carolina",3939,1706,2233,0.433104848946433,0.566895151053567
"45063021403","Census Tract 214.03, Lexington County, South Carolina",2440,1877,563,0.769262295081967,0.230737704918033
"45063021404","Census Tract 214.04, Lexington County, South Carolina",2638,2120,518,0.803639120545868,0.196360879454132
"45065920100","Census Tract 9201, McCormick County, South Carolina",2549,1553,996,0.609258532757944,0.390741467242056
"45065920200","Census Tract 9202, McCormick County, South Carolina",5549,2185,3364,0.393764642277888,0.606235357722112
"45065920300","Census Tract 9203, McCormick County, South Carolina",1993,1206,787,0.60511791269443,0.39488208730557
"45067950100","Census Tract 9501, Marion County, South Carolina",4806,1834,2972,0.38160632542655,0.61839367457345
"45067950200","Census Tract 9502, Marion County, South Carolina",6787,2657,4130,0.391483718874319,0.608516281125681
"45067950300","Census Tract 9503, Marion County, South Carolina",2765,679,2086,0.245569620253165,0.754430379746835
"45067950400","Census Tract 9504, Marion County, South Carolina",4113,2172,1941,0.528081692195478,0.471918307804522
"45067950500","Census Tract 9505, Marion County, South Carolina",4472,2422,2050,0.541592128801431,0.458407871198569
"45067950600","Census Tract 9506, Marion County, South Carolina",5964,1666,4298,0.279342723004695,0.720657276995305
"45067950700","Census Tract 9507, Marion County, South Carolina",1517,807,710,0.53197099538563,0.46802900461437
"45067950800","Census Tract 9508, Marion County, South Carolina",2271,1241,1030,0.546455306032585,0.453544693967415
"45069960100","Census Tract 9601, Marlboro County, South Carolina",3182,1780,1402,0.559396605908234,0.440603394091766
"45069960200","Census Tract 9602, Marlboro County, South Carolina",5642,1412,4230,0.250265863169089,0.749734136830911
"45069960301","Census Tract 9603.01, Marlboro County, South Carolina",5148,2152,2996,0.418026418026418,0.581973581973582
"45069960302","Census Tract 9603.02, Marlboro County, South Carolina",5110,1708,3402,0.334246575342466,0.665753424657534
"45069960400","Census Tract 9604, Marlboro County, South Carolina",5317,2788,2529,0.524355839759263,0.475644160240737
"45069960500","Census Tract 9605, Marlboro County, South Carolina",1827,631,1196,0.345374931581828,0.654625068418172
"45069960600","Census Tract 9606, Marlboro County, South Carolina",2316,1384,932,0.597582037996546,0.402417962003454
"45071950100","Census Tract 9501, Newberry County, South Carolina",3698,2753,945,0.744456462952948,0.255543537047052
"45071950201","Census Tract 9502.01, Newberry County, South Carolina",2775,1163,1612,0.419099099099099,0.580900900900901
"45071950202","Census Tract 9502.02, Newberry County, South Carolina",7364,4726,2638,0.641770776751765,0.358229223248235
"45071950300","Census Tract 9503, Newberry County, South Carolina",3260,2430,830,0.745398773006135,0.254601226993865
"45071950502","Census Tract 9505.02, Newberry County, South Carolina",5593,1673,3920,0.299123904881101,0.700876095118899
"45071950601","Census Tract 9506.01, Newberry County, South Carolina",4601,3163,1438,0.687459247989567,0.312540752010433
"45071950602","Census Tract 9506.02, Newberry County, South Carolina",5828,4872,956,0.835964310226493,0.164035689773507
"45071950700","Census Tract 9507, Newberry County, South Carolina",4395,2425,1970,0.551763367463026,0.448236632536974
"45073030100","Census Tract 301, Oconee County, South Carolina",4016,3891,125,0.968874501992032,0.0311254980079682
"45073030200","Census Tract 302, Oconee County, South Carolina",5879,5826,53,0.990984861370981,0.00901513862901859
"45073030300","Census Tract 303, Oconee County, South Carolina",6976,6857,119,0.982941513761468,0.0170584862385321
"45073030401","Census Tract 304.01, Oconee County, South Carolina",6758,5413,1345,0.800976620301864,0.199023379698136
"45073030402","Census Tract 304.02, Oconee County, South Carolina",1590,1557,33,0.979245283018868,0.0207547169811321
"45073030500","Census Tract 305, Oconee County, South Carolina",4585,4285,300,0.934569247546347,0.0654307524536533
"45073030601","Census Tract 306.01, Oconee County, South Carolina",4454,4062,392,0.911989223170184,0.088010776829816
"45073030602","Census Tract 306.02, Oconee County, South Carolina",4385,3872,513,0.883010262257697,0.116989737742303
"45073030701","Census Tract 307.01, Oconee County, South Carolina",3367,2275,1092,0.675675675675676,0.324324324324324
"45073030702","Census Tract 307.02, Oconee County, South Carolina",5967,4583,1384,0.768057650410592,0.231942349589408
"45073030800","Census Tract 308, Oconee County, South Carolina",6960,4991,1969,0.717097701149425,0.282902298850575
"45073030901","Census Tract 309.01, Oconee County, South Carolina",2885,2826,59,0.979549393414211,0.0204506065857886
"45073030902","Census Tract 309.02, Oconee County, South Carolina",8173,7834,339,0.958521962559648,0.0414780374403524
"45073031000","Census Tract 310, Oconee County, South Carolina",4791,4294,497,0.896263828010854,0.103736171989146
"45073031100","Census Tract 311, Oconee County, South Carolina",3633,3500,133,0.963391136801541,0.0366088631984586
"45075010100","Census Tract 101, Orangeburg County, South Carolina",4994,1928,3066,0.386063275931117,0.613936724068883
"45075010200","Census Tract 102, Orangeburg County, South Carolina",4991,1311,3680,0.262672811059908,0.737327188940092
"45075010300","Census Tract 103, Orangeburg County, South Carolina",6357,1638,4719,0.257668711656442,0.742331288343558
"45075010400","Census Tract 104, Orangeburg County, South Carolina",3894,1519,2375,0.390087313816127,0.609912686183873
"45075010500","Census Tract 105, Orangeburg County, South Carolina",3957,1413,2544,0.357088703563306,0.642911296436695
"45075010600","Census Tract 106, Orangeburg County, South Carolina",4804,1079,3725,0.224604496253122,0.775395503746878
"45075010700","Census Tract 107, Orangeburg County, South Carolina",2837,1003,1834,0.353542474444836,0.646457525555164
"45075010800","Census Tract 108, Orangeburg County, South Carolina",4433,607,3826,0.136927588540492,0.863072411459508
"45075010900","Census Tract 109, Orangeburg County, South Carolina",8455,3484,4971,0.412063867534004,0.587936132465996
"45075011000","Census Tract 110, Orangeburg County, South Carolina",5720,1476,4244,0.258041958041958,0.741958041958042
"45075011100","Census Tract 111, Orangeburg County, South Carolina",3316,187,3129,0.0563932448733414,0.943606755126659
"45075011200","Census Tract 112, Orangeburg County, South Carolina",2719,114,2605,0.0419271791099669,0.958072820890033
"45075011300","Census Tract 113, Orangeburg County, South Carolina",3253,412,2841,0.126652320934522,0.873347679065478
"45075011400","Census Tract 114, Orangeburg County, South Carolina",3867,830,3037,0.214636669252651,0.785363330747349
"45075011500","Census Tract 115, Orangeburg County, South Carolina",3993,1473,2520,0.368895567242675,0.631104432757325
"45075011600","Census Tract 116, Orangeburg County, South Carolina",6210,3197,3013,0.514814814814815,0.485185185185185
"45075011700","Census Tract 117, Orangeburg County, South Carolina",5111,3476,1635,0.680101741342203,0.319898258657797
"45075011800","Census Tract 118, Orangeburg County, South Carolina",5204,2020,3184,0.388162951575711,0.611837048424289
"45075011900","Census Tract 119, Orangeburg County, South Carolina",3981,2766,1215,0.694800301431801,0.305199698568199
"45075012000","Census Tract 120, Orangeburg County, South Carolina",3740,1798,1942,0.480748663101604,0.519251336898396
"45077010100","Census Tract 101, Pickens County, South Carolina",2927,2717,210,0.928254185172532,0.0717458148274684
"45077010200","Census Tract 102, Pickens County, South Carolina",4318,4092,226,0.947660954145438,0.0523390458545623
"45077010300","Census Tract 103, Pickens County, South Carolina",5367,5076,291,0.945779765231973,0.0542202347680268
"45077010401","Census Tract 104.01, Pickens County, South Carolina",1885,1835,50,0.973474801061008,0.0265251989389921
"45077010402","Census Tract 104.02, Pickens County, South Carolina",4994,4791,203,0.959351221465759,0.0406487785342411
"45077010403","Census Tract 104.03, Pickens County, South Carolina",1905,1849,56,0.970603674540682,0.0293963254593176
"45077010501","Census Tract 105.01, Pickens County, South Carolina",2881,2776,105,0.963554321416175,0.0364456785838251
"45077010502","Census Tract 105.02, Pickens County, South Carolina",3243,2977,266,0.917977181621955,0.082022818378045
"45077010601","Census Tract 106.01, Pickens County, South Carolina",3513,3425,88,0.974950185027042,0.0250498149729576
"45077010602","Census Tract 106.02, Pickens County, South Carolina",6702,6508,194,0.97105341689048,0.0289465831095196
"45077010700","Census Tract 107, Pickens County, South Carolina",4548,4129,419,0.907871591908531,0.0921284080914688
"45077010801","Census Tract 108.01, Pickens County, South Carolina",4923,3932,991,0.798699979687183,0.201300020312817
"45077010802","Census Tract 108.02, Pickens County, South Carolina",3162,2820,342,0.891840607210626,0.108159392789374
"45077010803","Census Tract 108.03, Pickens County, South Carolina",4705,3414,1291,0.725611052072264,0.274388947927736
"45077010804","Census Tract 108.04, Pickens County, South Carolina",3353,2922,431,0.871458395466746,0.128541604533254
"45077010901","Census Tract 109.01, Pickens County, South Carolina",5137,4631,506,0.901498929336188,0.0985010706638115
"45077010902","Census Tract 109.02, Pickens County, South Carolina",6609,5806,803,0.878499016492661,0.121500983507339
"45077010903","Census Tract 109.03, Pickens County, South Carolina",5440,4900,540,0.900735294117647,0.0992647058823529
"45077011001","Census Tract 110.01, Pickens County, South Carolina",3222,3018,204,0.936685288640596,0.0633147113594041
"45077011002","Census Tract 110.02, Pickens County, South Carolina",6427,5690,737,0.88532752450599,0.11467247549401
"45077011003","Census Tract 110.03, Pickens County, South Carolina",2425,2348,77,0.968247422680412,0.0317525773195876
"45077011101","Census Tract 111.01, Pickens County, South Carolina",2450,2090,360,0.853061224489796,0.146938775510204
"45077011102","Census Tract 111.02, Pickens County, South Carolina",7439,5903,1536,0.793520634493884,0.206479365506116
"45077011103","Census Tract 111.03, Pickens County, South Carolina",1196,1183,13,0.989130434782609,0.0108695652173914
"45077011202","Census Tract 112.02, Pickens County, South Carolina",6498,5572,926,0.857494613727301,0.142505386272699
"45077011203","Census Tract 112.03, Pickens County, South Carolina",6221,5330,891,0.856775438032471,0.143224561967529
"45077011204","Census Tract 112.04, Pickens County, South Carolina",4321,3341,980,0.773200647998149,0.226799352001851
"45077011205","Census Tract 112.05, Pickens County, South Carolina",3672,2858,814,0.778322440087146,0.221677559912854
"45079000100","Census Tract 1, Richland County, South Carolina",2277,440,1837,0.193236714975845,0.806763285024155
"45079000200","Census Tract 2, Richland County, South Carolina",1922,229,1693,0.119146722164412,0.880853277835588
"45079000300","Census Tract 3, Richland County, South Carolina",3502,254,3248,0.0725299828669332,0.927470017133067
"45079000400","Census Tract 4, Richland County, South Carolina",1975,743,1232,0.37620253164557,0.62379746835443
"45079000500","Census Tract 5, Richland County, South Carolina",2387,84,2303,0.0351906158357771,0.964809384164223
"45079000600","Census Tract 6, Richland County, South Carolina",2595,1590,1005,0.61271676300578,0.38728323699422
"45079000700","Census Tract 7, Richland County, South Carolina",1774,1247,527,0.70293122886133,0.29706877113867
"45079000900","Census Tract 9, Richland County, South Carolina",2253,98,2155,0.0434975588104749,0.956502441189525
"45079001000","Census Tract 10, Richland County, South Carolina",3783,649,3134,0.171556965371398,0.828443034628602
"45079001100","Census Tract 11, Richland County, South Carolina",4109,2096,2013,0.510099780968606,0.489900219031394
"45079001200","Census Tract 12, Richland County, South Carolina",1879,1710,169,0.910058541777541,0.0899414582224588
"45079001300","Census Tract 13, Richland County, South Carolina",2565,329,2236,0.128265107212476,0.871734892787524
"45079001600","Census Tract 16, Richland County, South Carolina",1309,973,336,0.74331550802139,0.25668449197861
"45079002100","Census Tract 21, Richland County, South Carolina",2659,2305,354,0.866867243324558,0.133132756675442
"45079002200","Census Tract 22, Richland County, South Carolina",1557,1264,293,0.811817597944766,0.188182402055234
"45079002300","Census Tract 23, Richland County, South Carolina",2244,2135,109,0.951426024955437,0.0485739750445633
"45079002400","Census Tract 24, Richland County, South Carolina",4397,3788,609,0.861496474869229,0.138503525130771
"45079002500","Census Tract 25, Richland County, South Carolina",3508,3064,444,0.873432155074116,0.126567844925884
"45079002602","Census Tract 26.02, Richland County, South Carolina",2933,2166,767,0.738493010569383,0.261506989430617
"45079002603","Census Tract 26.03, Richland County, South Carolina",4900,2195,2705,0.447959183673469,0.552040816326531
"45079002604","Census Tract 26.04, Richland County, South Carolina",1757,650,1107,0.369948776323278,0.630051223676722
"45079002700","Census Tract 27, Richland County, South Carolina",3609,3116,493,0.86339706289831,0.13660293710169
"45079002800","Census Tract 28, Richland County, South Carolina",6604,4898,1706,0.741671714112659,0.258328285887341
"45079002900","Census Tract 29, Richland County, South Carolina",3286,2285,1001,0.695374315276932,0.304625684723068
"45079003000","Census Tract 30, Richland County, South Carolina",3121,2508,613,0.803588593399551,0.196411406600449
"45079003100","Census Tract 31, Richland County, South Carolina",899,396,503,0.440489432703003,0.559510567296997
"45079010102","Census Tract 101.02, Richland County, South Carolina",6235,3090,3145,0.495589414595028,0.504410585404972
"45079010103","Census Tract 101.03, Richland County, South Carolina",16098,6827,9271,0.424089949061995,0.575910050938005
"45079010104","Census Tract 101.04, Richland County, South Carolina",3882,2056,1826,0.529623905203503,0.470376094796497
"45079010200","Census Tract 102, Richland County, South Carolina",5044,2755,2289,0.546193497224425,0.453806502775575
"45079010304","Census Tract 103.04, Richland County, South Carolina",6219,2591,3628,0.416626467277697,0.583373532722303
"45079010305","Census Tract 103.05, Richland County, South Carolina",7138,4807,2331,0.673437937797702,0.326562062202298
"45079010306","Census Tract 103.06, Richland County, South Carolina",8333,7417,916,0.890075603024121,0.109924396975879
"45079010307","Census Tract 103.07, Richland County, South Carolina",8618,7305,1313,0.847644465073103,0.152355534926897
"45079010308","Census Tract 103.08, Richland County, South Carolina",5525,3752,1773,0.679095022624434,0.320904977375566
"45079010309","Census Tract 103.09, Richland County, South Carolina",9293,5960,3333,0.641342946303669,0.358657053696331
"45079010403","Census Tract 104.03, Richland County, South Carolina",3797,1461,2336,0.384777455886226,0.615222544113774
"45079010407","Census Tract 104.07, Richland County, South Carolina",4879,684,4195,0.140192662430826,0.859807337569174
"45079010408","Census Tract 104.08, Richland County, South Carolina",5683,1660,4023,0.292099243357382,0.707900756642618
"45079010409","Census Tract 104.09, Richland County, South Carolina",1627,324,1303,0.199139520590043,0.800860479409957
"45079010410","Census Tract 104.10, Richland County, South Carolina",3434,592,2842,0.172393709959231,0.827606290040769
"45079010411","Census Tract 104.11, Richland County, South Carolina",3307,484,2823,0.146356214091321,0.853643785908679
"45079010412","Census Tract 104.12, Richland County, South Carolina",3707,1273,2434,0.343404370110602,0.656595629889398
"45079010413","Census Tract 104.13, Richland County, South Carolina",2008,642,1366,0.319721115537849,0.680278884462151
"45079010501","Census Tract 105.01, Richland County, South Carolina",2122,963,1159,0.453817153628652,0.546182846371348
"45079010600","Census Tract 106, Richland County, South Carolina",4654,391,4263,0.084013751611517,0.915986248388483
"45079010701","Census Tract 107.01, Richland County, South Carolina",3111,70,3041,0.0225008036001286,0.977499196399871
"45079010702","Census Tract 107.02, Richland County, South Carolina",3544,107,3437,0.0301918735891648,0.969808126410835
"45079010703","Census Tract 107.03, Richland County, South Carolina",3443,134,3309,0.0389195469067674,0.961080453093233
"45079010803","Census Tract 108.03, Richland County, South Carolina",2236,353,1883,0.157871198568873,0.842128801431127
"45079010804","Census Tract 108.04, Richland County, South Carolina",2283,321,1962,0.140604467805519,0.859395532194481
"45079010805","Census Tract 108.05, Richland County, South Carolina",1883,386,1497,0.204992033988317,0.795007966011683
"45079010806","Census Tract 108.06, Richland County, South Carolina",1052,338,714,0.321292775665399,0.678707224334601
"45079010900","Census Tract 109, Richland County, South Carolina",2828,41,2787,0.0144978783592645,0.985502121640735
"45079011000","Census Tract 110, Richland County, South Carolina",1816,138,1678,0.0759911894273128,0.924008810572687
"45079011101","Census Tract 111.01, Richland County, South Carolina",3791,2665,1126,0.702980743867054,0.297019256132946
"45079011102","Census Tract 111.02, Richland County, South Carolina",3465,2641,824,0.762193362193362,0.237806637806638
"45079011201","Census Tract 112.01, Richland County, South Carolina",1960,1823,137,0.930102040816327,0.0698979591836735
"45079011202","Census Tract 112.02, Richland County, South Carolina",3532,2867,665,0.811721404303511,0.188278595696489
"45079011301","Census Tract 113.01, Richland County, South Carolina",6033,3949,2084,0.654566550638157,0.345433449361843
"45079011303","Census Tract 113.03, Richland County, South Carolina",5218,1077,4141,0.206400919892679,0.793599080107321
"45079011304","Census Tract 113.04, Richland County, South Carolina",5552,1994,3558,0.359149855907781,0.640850144092219
"45079011305","Census Tract 113.05, Richland County, South Carolina",5337,1717,3620,0.321716320029979,0.678283679970021
"45079011404","Census Tract 114.04, Richland County, South Carolina",8321,2127,6194,0.255618315106357,0.744381684893643
"45079011407","Census Tract 114.07, Richland County, South Carolina",3498,2121,1377,0.606346483704974,0.393653516295026
"45079011411","Census Tract 114.11, Richland County, South Carolina",3543,2189,1354,0.617837990403613,0.382162009596387
"45079011412","Census Tract 114.12, Richland County, South Carolina",5005,2243,2762,0.448151848151848,0.551848151848152
"45079011413","Census Tract 114.13, Richland County, South Carolina",8703,4899,3804,0.562909341606343,0.437090658393657
"45079011414","Census Tract 114.14, Richland County, South Carolina",5584,2905,2679,0.520236389684814,0.479763610315186
"45079011415","Census Tract 114.15, Richland County, South Carolina",10494,4645,5849,0.442633886030112,0.557366113969888
"45079011416","Census Tract 114.16, Richland County, South Carolina",11285,6118,5167,0.542135578201152,0.457864421798848
"45079011417","Census Tract 114.17, Richland County, South Carolina",8882,2642,6240,0.297455528034227,0.702544471965773
"45079011418","Census Tract 114.18, Richland County, South Carolina",3981,2350,1631,0.59030394373273,0.40969605626727
"45079011419","Census Tract 114.19, Richland County, South Carolina",4375,1741,2634,0.397942857142857,0.602057142857143
"45079011501","Census Tract 115.01, Richland County, South Carolina",9858,6149,3709,0.623757354432948,0.376242645567052
"45079011502","Census Tract 115.02, Richland County, South Carolina",2587,1285,1302,0.496714340935446,0.503285659064554
"45079011603","Census Tract 116.03, Richland County, South Carolina",5140,3841,1299,0.74727626459144,0.25272373540856
"45079011604","Census Tract 116.04, Richland County, South Carolina",5448,4765,683,0.874632892804699,0.125367107195301
"45079011606","Census Tract 116.06, Richland County, South Carolina",4730,1927,2803,0.407399577167019,0.592600422832981
"45079011607","Census Tract 116.07, Richland County, South Carolina",3926,1262,2664,0.321446765155374,0.678553234844626
"45079011608","Census Tract 116.08, Richland County, South Carolina",6872,3002,3870,0.436845168800931,0.563154831199069
"45079011701","Census Tract 117.01, Richland County, South Carolina",5325,3854,1471,0.723755868544601,0.276244131455399
"45079011702","Census Tract 117.02, Richland County, South Carolina",3799,274,3525,0.0721242432219005,0.9278757567781
"45079011800","Census Tract 118, Richland County, South Carolina",6669,912,5757,0.136752136752137,0.863247863247863
"45079011901","Census Tract 119.01, Richland County, South Carolina",8182,1353,6829,0.165362991933513,0.834637008066487
"45079011902","Census Tract 119.02, Richland County, South Carolina",5045,2936,2109,0.581962338949455,0.418037661050545
"45079012000","Census Tract 120, Richland County, South Carolina",5201,1547,3654,0.297442799461642,0.702557200538358
"45079980100","Census Tract 9801, Richland County, South Carolina",174,80,94,0.459770114942529,0.540229885057471
"45081960100","Census Tract 9601, Saluda County, South Carolina",2798,1895,903,0.677269478198713,0.322730521801287
"45081960201","Census Tract 9602.01, Saluda County, South Carolina",5658,2882,2776,0.509367267585719,0.490632732414281
"45081960202","Census Tract 9602.02, Saluda County, South Carolina",3435,1689,1746,0.491703056768559,0.508296943231441
"45081960300","Census Tract 9603, Saluda County, South Carolina",4760,4200,560,0.882352941176471,0.117647058823529
"45081960400","Census Tract 9604, Saluda County, South Carolina",3244,2111,1133,0.650739827373613,0.349260172626387
"45083020301","Census Tract 203.01, Spartanburg County, South Carolina",2663,1253,1410,0.470521967705595,0.529478032294405
"45083020400","Census Tract 204, Spartanburg County, South Carolina",970,274,696,0.282474226804124,0.717525773195876
"45083020500","Census Tract 205, Spartanburg County, South Carolina",1472,95,1377,0.0645380434782609,0.935461956521739
"45083020601","Census Tract 206.01, Spartanburg County, South Carolina",2710,980,1730,0.361623616236162,0.638376383763838
"45083020602","Census Tract 206.02, Spartanburg County, South Carolina",1961,961,1000,0.490056093829679,0.509943906170321
"45083020603","Census Tract 206.03, Spartanburg County, South Carolina",2385,1346,1039,0.564360587002096,0.435639412997904
"45083020701","Census Tract 207.01, Spartanburg County, South Carolina",3316,604,2712,0.182147165259349,0.817852834740651
"45083020702","Census Tract 207.02, Spartanburg County, South Carolina",1733,719,1014,0.414887478361223,0.585112521638777
"45083020800","Census Tract 208, Spartanburg County, South Carolina",1560,37,1523,0.0237179487179487,0.976282051282051
"45083020900","Census Tract 209, Spartanburg County, South Carolina",1391,524,867,0.376707404744788,0.623292595255212
"45083021001","Census Tract 210.01, Spartanburg County, South Carolina",2483,320,2163,0.128876359242851,0.871123640757149
"45083021100","Census Tract 211, Spartanburg County, South Carolina",3491,1562,1929,0.447436264680607,0.552563735319393
"45083021200","Census Tract 212, Spartanburg County, South Carolina",3512,2910,602,0.828587699316629,0.171412300683371
"45083021301","Census Tract 213.01, Spartanburg County, South Carolina",2401,1408,993,0.586422324031654,0.413577675968346
"45083021302","Census Tract 213.02, Spartanburg County, South Carolina",2542,2428,114,0.955153422501967,0.044846577498033
"45083021303","Census Tract 213.03, Spartanburg County, South Carolina",5645,4671,974,0.827457927369353,0.172542072630647
"45083021401","Census Tract 214.01, Spartanburg County, South Carolina",1573,1352,221,0.859504132231405,0.140495867768595
"45083021402","Census Tract 214.02, Spartanburg County, South Carolina",3544,3110,434,0.877539503386005,0.122460496613995
"45083021403","Census Tract 214.03, Spartanburg County, South Carolina",3975,2259,1716,0.568301886792453,0.431698113207547
"45083021500","Census Tract 215, Spartanburg County, South Carolina",3074,2059,1015,0.669811320754717,0.330188679245283
"45083021600","Census Tract 216, Spartanburg County, South Carolina",2714,1242,1472,0.457627118644068,0.542372881355932
"45083021700","Census Tract 217, Spartanburg County, South Carolina",4382,1887,2495,0.430625285257873,0.569374714742127
"45083021802","Census Tract 218.02, Spartanburg County, South Carolina",6048,3810,2238,0.629960317460317,0.370039682539683
"45083021803","Census Tract 218.03, Spartanburg County, South Carolina",6309,4570,1739,0.724362022507529,0.275637977492471
"45083021804","Census Tract 218.04, Spartanburg County, South Carolina",2682,1465,1217,0.546234153616704,0.453765846383296
"45083021901","Census Tract 219.01, Spartanburg County, South Carolina",5598,4596,1002,0.821007502679528,0.178992497320472
"45083021902","Census Tract 219.02, Spartanburg County, South Carolina",6304,4955,1349,0.786008883248731,0.213991116751269
"45083022003","Census Tract 220.03, Spartanburg County, South Carolina",3700,2666,1034,0.720540540540541,0.279459459459459
"45083022004","Census Tract 220.04, Spartanburg County, South Carolina",2955,1317,1638,0.445685279187817,0.554314720812183
"45083022005","Census Tract 220.05, Spartanburg County, South Carolina",5598,3788,1810,0.676670239371204,0.323329760628796
"45083022006","Census Tract 220.06, Spartanburg County, South Carolina",4220,1305,2915,0.309241706161137,0.690758293838863
"45083022007","Census Tract 220.07, Spartanburg County, South Carolina",3096,1960,1136,0.633074935400517,0.366925064599483
"45083022101","Census Tract 221.01, Spartanburg County, South Carolina",3721,2546,1175,0.684224670787423,0.315775329212577
"45083022102","Census Tract 221.02, Spartanburg County, South Carolina",2293,2194,99,0.956825119930222,0.0431748800697775
"45083022201","Census Tract 222.01, Spartanburg County, South Carolina",4548,4040,508,0.88830255057168,0.11169744942832
"45083022202","Census Tract 222.02, Spartanburg County, South Carolina",3754,3197,557,0.851624933404369,0.148375066595631
"45083022302","Census Tract 223.02, Spartanburg County, South Carolina",5227,4763,464,0.91123015113832,0.0887698488616797
"45083022303","Census Tract 223.03, Spartanburg County, South Carolina",1927,1482,445,0.769071094966269,0.230928905033731
"45083022304","Census Tract 223.04, Spartanburg County, South Carolina",4374,4011,363,0.917009602194787,0.0829903978052127
"45083022401","Census Tract 224.01, Spartanburg County, South Carolina",6010,4704,1306,0.782695507487521,0.217304492512479
"45083022403","Census Tract 224.03, Spartanburg County, South Carolina",8181,6946,1235,0.849040459601516,0.150959540398484
"45083022404","Census Tract 224.04, Spartanburg County, South Carolina",5222,4630,592,0.886633473764841,0.113366526235159
"45083022405","Census Tract 224.05, Spartanburg County, South Carolina",3928,3678,250,0.936354378818737,0.0636456211812627
"45083022406","Census Tract 224.06, Spartanburg County, South Carolina",6248,5218,1030,0.835147247119078,0.164852752880922
"45083022500","Census Tract 225, Spartanburg County, South Carolina",4011,3844,167,0.958364497631513,0.0416355023684867
"45083022600","Census Tract 226, Spartanburg County, South Carolina",3195,2811,384,0.87981220657277,0.12018779342723
"45083022700","Census Tract 227, Spartanburg County, South Carolina",6986,6442,544,0.922129974234183,0.0778700257658174
"45083022801","Census Tract 228.01, Spartanburg County, South Carolina",5880,4654,1226,0.791496598639456,0.208503401360544
"45083022802","Census Tract 228.02, Spartanburg County, South Carolina",6992,5438,1554,0.777745995423341,0.222254004576659
"45083022900","Census Tract 229, Spartanburg County, South Carolina",7005,5336,1669,0.761741613133476,0.238258386866524
"45083023001","Census Tract 230.01, Spartanburg County, South Carolina",7396,6298,1098,0.851541373715522,0.148458626284478
"45083023002","Census Tract 230.02, Spartanburg County, South Carolina",3085,2195,890,0.711507293354943,0.288492706645057
"45083023101","Census Tract 231.01, Spartanburg County, South Carolina",5714,3223,2491,0.564053202660133,0.435946797339867
"45083023102","Census Tract 231.02, Spartanburg County, South Carolina",5671,4126,1545,0.727561276670781,0.272438723329219
"45083023201","Census Tract 232.01, Spartanburg County, South Carolina",3934,3555,379,0.903660396542959,0.0963396034570412
"45083023202","Census Tract 232.02, Spartanburg County, South Carolina",3914,3315,599,0.846959632089934,0.153040367910066
"45083023301","Census Tract 233.01, Spartanburg County, South Carolina",1751,1539,212,0.878926327812678,0.121073672187322
"45083023302","Census Tract 233.02, Spartanburg County, South Carolina",5182,2491,2691,0.480702431493632,0.519297568506368
"45083023401","Census Tract 234.01, Spartanburg County, South Carolina",2220,1525,695,0.686936936936937,0.313063063063063
"45083023402","Census Tract 234.02, Spartanburg County, South Carolina",4225,3720,505,0.880473372781065,0.119526627218935
"45083023403","Census Tract 234.03, Spartanburg County, South Carolina",6696,4686,2010,0.699820788530466,0.300179211469534
"45083023404","Census Tract 234.04, Spartanburg County, South Carolina",5907,5046,861,0.854240731335703,0.145759268664297
"45083023405","Census Tract 234.05, Spartanburg County, South Carolina",4531,4059,472,0.895828735378504,0.104171264621496
"45083023500","Census Tract 235, Spartanburg County, South Carolina",4519,4091,428,0.905288780703696,0.0947112192963044
"45083023600","Census Tract 236, Spartanburg County, South Carolina",6209,4507,1702,0.725881784506362,0.274118215493638
"45083023700","Census Tract 237, Spartanburg County, South Carolina",4307,3794,513,0.880891571859763,0.119108428140237
"45083023801","Census Tract 238.01, Spartanburg County, South Carolina",5184,4378,806,0.844521604938272,0.155478395061728
"45083023802","Census Tract 238.02, Spartanburg County, South Carolina",5673,4798,875,0.84576062048299,0.15423937951701
"45083023900","Census Tract 239, Spartanburg County, South Carolina",5162,3970,1192,0.769081751259202,0.230918248740798
"45085000100","Census Tract 1, Sumter County, South Carolina",3098,581,2517,0.187540348612008,0.812459651387992
"45085000201","Census Tract 2.01, Sumter County, South Carolina",4001,2166,1835,0.541364658835291,0.458635341164709
"45085000202","Census Tract 2.02, Sumter County, South Carolina",6032,2563,3469,0.424900530503979,0.575099469496021
"45085000300","Census Tract 3, Sumter County, South Carolina",3269,2107,1162,0.644539614561028,0.355460385438972
"45085000400","Census Tract 4, Sumter County, South Carolina",8658,4201,4457,0.485215985215985,0.514784014784015
"45085000500","Census Tract 5, Sumter County, South Carolina",2152,691,1461,0.321096654275093,0.678903345724907
"45085000600","Census Tract 6, Sumter County, South Carolina",3758,2030,1728,0.5401809473124,0.4598190526876
"45085000700","Census Tract 7, Sumter County, South Carolina",4466,1675,2791,0.375055978504254,0.624944021495746
"45085000800","Census Tract 8, Sumter County, South Carolina",4181,537,3644,0.12843817268596,0.87156182731404
"45085000901","Census Tract 9.01, Sumter County, South Carolina",3633,1617,2016,0.445086705202312,0.554913294797688
"45085000902","Census Tract 9.02, Sumter County, South Carolina",4682,4076,606,0.870568133276378,0.129431866723622
"45085001100","Census Tract 11, Sumter County, South Carolina",5063,1131,3932,0.223385344657318,0.776614655342682
"45085001300","Census Tract 13, Sumter County, South Carolina",2424,529,1895,0.218234323432343,0.781765676567657
"45085001600","Census Tract 16, Sumter County, South Carolina",3938,167,3771,0.042407313357034,0.957592686642966
"45085001701","Census Tract 17.01, Sumter County, South Carolina",6876,5486,1390,0.797847585805701,0.202152414194299
"45085001703","Census Tract 17.03, Sumter County, South Carolina",5179,3397,1782,0.655918130913304,0.344081869086696
"45085001704","Census Tract 17.04, Sumter County, South Carolina",5810,2427,3383,0.417728055077453,0.582271944922547
"45085001801","Census Tract 18.01, Sumter County, South Carolina",4328,2635,1693,0.608826247689464,0.391173752310536
"45085001802","Census Tract 18.02, Sumter County, South Carolina",7764,3914,3850,0.504121586810922,0.495878413189078
"45085001901","Census Tract 19.01, Sumter County, South Carolina",6307,4706,1601,0.746155065799905,0.253844934200095
"45085001902","Census Tract 19.02, Sumter County, South Carolina",5832,3584,2248,0.614540466392318,0.385459533607682
"45085002000","Census Tract 20, Sumter County, South Carolina",4262,2300,1962,0.539652745190052,0.460347254809948
"45087030100","Census Tract 301, Union County, South Carolina",2230,1430,800,0.641255605381166,0.358744394618834
"45087030200","Census Tract 302, Union County, South Carolina",2421,1114,1307,0.460140437835605,0.539859562164395
"45087030300","Census Tract 303, Union County, South Carolina",4538,2968,1570,0.654032613486117,0.345967386513883
"45087030400","Census Tract 304, Union County, South Carolina",5767,3871,1896,0.671232876712329,0.328767123287671
"45087030500","Census Tract 305, Union County, South Carolina",2288,1718,570,0.750874125874126,0.249125874125874
"45087030600","Census Tract 306, Union County, South Carolina",1961,558,1403,0.284548699643039,0.715451300356961
"45087030700","Census Tract 307, Union County, South Carolina",3430,2727,703,0.795043731778426,0.204956268221574
"45087030800","Census Tract 308, Union County, South Carolina",3346,2486,860,0.742976688583383,0.257023311416617
"45087030900","Census Tract 309, Union County, South Carolina",2613,2157,456,0.82548794489093,0.17451205510907
"45089970100","Census Tract 9701, Williamsburg County, South Carolina",1895,1134,761,0.598416886543536,0.401583113456464
"45089970200","Census Tract 9702, Williamsburg County, South Carolina",1635,364,1271,0.22262996941896,0.77737003058104
"45089970300","Census Tract 9703, Williamsburg County, South Carolina",4967,2262,2705,0.455405677471311,0.544594322528689
"45089970400","Census Tract 9704, Williamsburg County, South Carolina",2743,1067,1676,0.388990156762669,0.611009843237331
"45089970501","Census Tract 9705.01, Williamsburg County, South Carolina",3741,837,2904,0.22373696872494,0.77626303127506
"45089970502","Census Tract 9705.02, Williamsburg County, South Carolina",4283,351,3932,0.0819519028718188,0.918048097128181
"45089970600","Census Tract 9706, Williamsburg County, South Carolina",5330,2351,2979,0.44108818011257,0.55891181988743
"45089970700","Census Tract 9707, Williamsburg County, South Carolina",2649,481,2168,0.181577953944885,0.818422046055115
"45089970801","Census Tract 9708.01, Williamsburg County, South Carolina",4161,496,3665,0.119202114876232,0.880797885123768
"45089970900","Census Tract 9709, Williamsburg County, South Carolina",2540,1370,1170,0.539370078740158,0.460629921259842
"45091060102","Census Tract 601.02, York County, South Carolina",2723,2346,377,0.861549761292692,0.138450238707308
"45091060200","Census Tract 602, York County, South Carolina",3866,2253,1613,0.58277289187791,0.41722710812209
"45091060300","Census Tract 603, York County, South Carolina",4043,1094,2949,0.270591145189216,0.729408854810784
"45091060401","Census Tract 604.01, York County, South Carolina",2155,274,1881,0.127146171693735,0.872853828306265
"45091060402","Census Tract 604.02, York County, South Carolina",1795,211,1584,0.117548746518106,0.882451253481894
"45091060501","Census Tract 605.01, York County, South Carolina",3244,1136,2108,0.350184956843403,0.649815043156597
"45091060502","Census Tract 605.02, York County, South Carolina",2509,214,2295,0.0852929453965723,0.914707054603428
"45091060600","Census Tract 606, York County, South Carolina",1739,934,805,0.537090281771133,0.462909718228867
"45091060700","Census Tract 607, York County, South Carolina",4926,3876,1050,0.786845310596833,0.213154689403167
"45091060802","Census Tract 608.02, York County, South Carolina",1877,1637,240,0.872136387852957,0.127863612147043
"45091060803","Census Tract 608.03, York County, South Carolina",5208,3488,1720,0.66973886328725,0.33026113671275
"45091060804","Census Tract 608.04, York County, South Carolina",4142,3184,958,0.768710767745051,0.231289232254949
"45091060901","Census Tract 609.01, York County, South Carolina",4751,2643,2108,0.556303936013471,0.443696063986529
"45091060904","Census Tract 609.04, York County, South Carolina",6289,5074,1215,0.80680553347114,0.19319446652886
"45091060905","Census Tract 609.05, York County, South Carolina",8960,6647,2313,0.741852678571429,0.258147321428571
"45091060906","Census Tract 609.06, York County, South Carolina",8644,7605,1039,0.8798010180472,0.1201989819528
"45091060907","Census Tract 609.07, York County, South Carolina",9280,6938,2342,0.747629310344828,0.252370689655172
"45091061003","Census Tract 610.03, York County, South Carolina",9689,8781,908,0.906285478377542,0.0937145216224584
"45091061004","Census Tract 610.04, York County, South Carolina",7293,6139,1154,0.841766077060195,0.158233922939805
"45091061005","Census Tract 610.05, York County, South Carolina",8953,7727,1226,0.863062660560706,0.136937339439294
"45091061006","Census Tract 610.06, York County, South Carolina",2949,2568,381,0.870803662258393,0.129196337741607
"45091061007","Census Tract 610.07, York County, South Carolina",6885,5506,1379,0.799709513435004,0.200290486564996
"45091061008","Census Tract 610.08, York County, South Carolina",3739,3189,550,0.852901845413212,0.147098154586788
"45091061101","Census Tract 611.01, York County, South Carolina",3807,3140,667,0.824796427633307,0.175203572366693
"45091061103","Census Tract 611.03, York County, South Carolina",5528,4792,736,0.866859623733719,0.133140376266281
"45091061104","Census Tract 611.04, York County, South Carolina",3765,3505,260,0.930942895086321,0.0690571049136787
"45091061201","Census Tract 612.01, York County, South Carolina",7365,5214,2151,0.707942973523422,0.292057026476578
"45091061202","Census Tract 612.02, York County, South Carolina",4531,3477,1054,0.767380269256235,0.232619730743765
"45091061203","Census Tract 612.03, York County, South Carolina",6047,5064,983,0.837440052918803,0.162559947081197
"45091061301","Census Tract 613.01, York County, South Carolina",5125,1892,3233,0.369170731707317,0.630829268292683
"45091061302","Census Tract 613.02, York County, South Carolina",5023,3510,1513,0.698785586303006,0.301214413696994
"45091061401","Census Tract 614.01, York County, South Carolina",4024,3399,625,0.844681908548708,0.155318091451292
"45091061403","Census Tract 614.03, York County, South Carolina",5119,4260,859,0.832193787849189,0.167806212150811
"45091061404","Census Tract 614.04, York County, South Carolina",3553,2550,1003,0.717703349282297,0.282296650717703
"45091061501","Census Tract 615.01, York County, South Carolina",7508,6621,887,0.881859350026638,0.118140649973362
"45091061502","Census Tract 615.02, York County, South Carolina",7988,7020,968,0.878818227341012,0.121181772658988
"45091061601","Census Tract 616.01, York County, South Carolina",2699,1319,1380,0.488699518340126,0.511300481659874
"45091061602","Census Tract 616.02, York County, South Carolina",5796,3349,2447,0.577812284334023,0.422187715665977
"45091061701","Census Tract 617.01, York County, South Carolina",4141,3840,301,0.927312243419464,0.0726877565805361
"45091061705","Census Tract 617.05, York County, South Carolina",4776,4585,191,0.96000837520938,0.0399916247906198
"45091061706","Census Tract 617.06, York County, South Carolina",4315,3894,421,0.902433371958285,0.0975666280417149
"45091061707","Census Tract 617.07, York County, South Carolina",8016,7099,917,0.88560379241517,0.11439620758483
"45091061708","Census Tract 617.08, York County, South Carolina",4293,3959,334,0.922198928488237,0.0778010715117633
"45091061801","Census Tract 618.01, York County, South Carolina",2806,1590,1216,0.56664290805417,0.43335709194583
"45091061802","Census Tract 618.02, York County, South Carolina",4619,4018,601,0.869885256549037,0.130114743450963
"45091061900","Census Tract 619, York County, South Carolina",4431,3743,688,0.844730309185285,0.155269690814715
