"GEOID","GEO.display.label","pop","pop.white","pop.not.white","pct.white","pct.not.white"
17031010201,17031010201,6450,2312,4138,0.358449612403101,0.641550387596899
17031010202,17031010202,2818,1237,1581,0.438963804116395,0.561036195883605
17031010300,17031010300,6236,3267,2969,0.523893521488133,0.476106478511867
17031010400,17031010400,5042,3341,1701,0.662633875446252,0.337366124553748
17031010503,17031010503,2290,1452,838,0.634061135371179,0.365938864628821
17031010600,17031010600,6097,3459,2638,0.567328194193866,0.432671805806134
17031010701,17031010701,3864,2125,1739,0.549948240165631,0.450051759834369
17031020100,17031020100,3965,1529,2436,0.38562421185372,0.61437578814628
17031020200,17031020200,6676,4069,2607,0.609496704613541,0.390503295386459
17031020302,17031020302,4650,3051,1599,0.656129032258065,0.343870967741935
17031020400,17031020400,4168,2266,1902,0.543666026871401,0.456333973128599
17031020602,17031020602,4340,2084,2256,0.480184331797235,0.519815668202765
17031020701,17031020701,1704,1088,616,0.63849765258216,0.36150234741784
17031020702,17031020702,7194,3618,3576,0.502919099249375,0.497080900750625
17031020801,17031020801,5458,2945,2513,0.539574935873946,0.460425064126054
17031020802,17031020802,6963,2347,4616,0.337067356024702,0.662932643975298
17031020901,17031020901,5221,1839,3382,0.352231373300134,0.647768626699866
17031020902,17031020902,4286,2095,2191,0.488800746616892,0.511199253383108
17031030101,17031030101,3893,2017,1876,0.518109427176984,0.481890572823016
17031030102,17031030102,3204,1898,1306,0.592384519350811,0.407615480649189
17031030104,17031030104,3681,2398,1283,0.65145340939962,0.34854659060038
17031030601,17031030601,4012,2179,1833,0.543120638085743,0.456879361914257
17031030701,17031030701,1549,827,722,0.533892834086507,0.466107165913493
17031030702,17031030702,1630,1006,624,0.617177914110429,0.382822085889571
17031030703,17031030703,2830,1717,1113,0.606713780918728,0.393286219081272
17031030706,17031030706,3599,2373,1226,0.659349819394276,0.340650180605724
17031030800,17031030800,4326,3333,993,0.770457697642164,0.229542302357836
17031031200,17031031200,5648,2168,3480,0.38385269121813,0.61614730878187
17031031300,17031031300,7076,3590,3486,0.507348784624081,0.492651215375919
17031031400,17031031400,5150,4066,1084,0.789514563106796,0.210485436893204
17031040100,17031040100,3985,2792,1193,0.700627352572146,0.299372647427854
17031040201,17031040201,6218,4513,1705,0.725796075908652,0.274203924091348
17031040401,17031040401,3092,2369,723,0.766170763260026,0.233829236739974
17031040402,17031040402,4468,3493,975,0.781781557743957,0.218218442256043
17031040700,17031040700,3123,2471,652,0.791226384886327,0.208773615113673
17031040800,17031040800,1514,1221,293,0.806472919418758,0.193527080581242
17031040900,17031040900,1950,1634,316,0.837948717948718,0.162051282051282
17031050100,17031050100,2290,1976,314,0.862882096069869,0.137117903930131
17031050500,17031050500,4754,4203,551,0.884097602019352,0.115902397980648
17031050700,17031050700,1418,1256,162,0.885754583921015,0.114245416078985
17031050800,17031050800,1289,1139,150,0.883630721489527,0.116369278510473
17031051200,17031051200,1516,1355,161,0.893799472295514,0.106200527704486
17031051300,17031051300,2683,2340,343,0.872158032053671,0.127841967946329
17031051400,17031051400,2077,1518,559,0.730861819932595,0.269138180067405
17031060100,17031060100,2569,2236,333,0.870377578824445,0.129622421175555
17031060200,17031060200,2111,1635,476,0.774514448128849,0.225485551871151
17031060500,17031060500,1309,1001,308,0.764705882352941,0.235294117647059
17031060800,17031060800,4837,3716,1121,0.768244779822204,0.231755220177796
17031061000,17031061000,1647,1481,166,0.899210686095932,0.100789313904068
17031061100,17031061100,1379,1276,103,0.925308194343727,0.0746918056562726
17031061200,17031061200,1889,1708,181,0.904182106934886,0.0958178930651138
17031061500,17031061500,1707,1562,145,0.915055653192736,0.0849443468072643
17031061800,17031061800,1112,889,223,0.799460431654676,0.200539568345324
17031061901,17031061901,3433,2811,622,0.818817360908826,0.181182639091174
17031062000,17031062000,2569,2251,318,0.876216426625146,0.123783573374854
17031062100,17031062100,3436,2949,487,0.858265424912689,0.141734575087311
17031062200,17031062200,2870,2560,310,0.89198606271777,0.10801393728223
17031062300,17031062300,1513,1389,124,0.918043621943159,0.0819563780568408
17031062500,17031062500,1497,1286,211,0.859051436205745,0.140948563794255
17031062600,17031062600,2226,1925,301,0.864779874213837,0.135220125786163
17031062700,17031062700,2724,2400,324,0.881057268722467,0.118942731277533
17031062900,17031062900,3976,3584,392,0.901408450704225,0.0985915492957746
17031063000,17031063000,2973,2536,437,0.853010427177935,0.146989572822065
17031063200,17031063200,6345,5326,1019,0.83940110323089,0.16059889676911
17031063301,17031063301,2641,2096,545,0.793638773191973,0.206361226808027
17031063302,17031063302,3996,3380,616,0.845845845845846,0.154154154154154
17031063303,17031063303,1201,1073,128,0.893422148209825,0.106577851790175
17031070102,17031070102,2413,2063,350,0.85495234148363,0.14504765851637
17031070103,17031070103,1709,1412,297,0.826214160327677,0.173785839672323
17031070200,17031070200,3900,3327,573,0.853076923076923,0.146923076923077
17031070400,17031070400,2984,2646,338,0.886729222520107,0.113270777479893
17031070500,17031070500,2928,2647,281,0.904030054644809,0.0959699453551912
17031070600,17031070600,2981,2630,351,0.882254277088225,0.117745722911775
17031071100,17031071100,2944,2590,354,0.879755434782609,0.120244565217391
17031071200,17031071200,1906,1679,227,0.88090241343127,0.11909758656873
17031071400,17031071400,4570,3888,682,0.850765864332604,0.149234135667396
17031071500,17031071500,5768,5100,668,0.884188626907074,0.115811373092926
17031071800,17031071800,2646,2051,595,0.775132275132275,0.224867724867725
17031080100,17031080100,6013,5448,565,0.906036920006652,0.0939630799933477
17031080202,17031080202,3498,3112,386,0.889651229273871,0.110348770726129
17031080300,17031080300,4315,3590,725,0.831981460023175,0.168018539976825
17031081000,17031081000,7546,5672,1874,0.751656506758548,0.248343493241452
17031081100,17031081100,3640,2713,927,0.74532967032967,0.25467032967033
17031081201,17031081201,4059,3422,637,0.843064794284306,0.156935205715694
17031081202,17031081202,2995,2713,282,0.905843071786311,0.0941569282136895
17031081300,17031081300,4884,4110,774,0.841523341523342,0.158476658476658
17031081401,17031081401,2279,1733,546,0.760421237384818,0.239578762615182
17031081402,17031081402,4243,3027,1216,0.713410322884751,0.286589677115249
17031081403,17031081403,6229,4384,1845,0.70380478407449,0.29619521592551
17031081500,17031081500,4379,3398,981,0.775976250285453,0.224023749714547
17031081700,17031081700,3102,2119,983,0.683107672469375,0.316892327530625
17031081800,17031081800,6866,5783,1083,0.842266239440722,0.157733760559278
17031081900,17031081900,1053,428,625,0.406457739791073,0.593542260208927
17031090100,17031090100,3405,3175,230,0.932452276064611,0.0675477239353891
17031090200,17031090200,6564,6192,372,0.943327239488117,0.056672760511883
17031090300,17031090300,1372,1290,82,0.940233236151603,0.0597667638483965
17031100100,17031100100,5313,4649,664,0.87502352719744,0.12497647280256
17031100200,17031100200,6749,6216,533,0.921025337086976,0.0789746629130241
17031100400,17031100400,3066,2792,274,0.910632746249185,0.0893672537508154
17031100500,17031100500,5779,5083,696,0.879563938397647,0.120436061602353
17031100600,17031100600,4832,4179,653,0.864859271523179,0.135140728476821
17031100700,17031100700,4826,4119,707,0.853501864898467,0.146498135101533
17031110200,17031110200,2828,2244,584,0.793493635077793,0.206506364922207
17031110300,17031110300,5161,4174,987,0.808757992637086,0.191242007362914
17031110501,17031110501,4639,3422,1217,0.737658978228066,0.262341021771934
17031110502,17031110502,3214,2450,764,0.762289981331674,0.237710018668326
17031120100,17031120100,4198,3788,410,0.902334444973797,0.097665555026203
17031120200,17031120200,4430,3863,567,0.872009029345372,0.127990970654628
17031120300,17031120300,6365,5036,1329,0.791201885310291,0.208798114689709
17031120400,17031120400,3515,2504,1011,0.712375533428165,0.287624466571835
17031130100,17031130100,5133,3393,1740,0.661016949152542,0.338983050847458
17031130200,17031130200,1412,1033,379,0.731586402266289,0.268413597733711
17031130300,17031130300,5064,2495,2569,0.492693522906793,0.507306477093207
17031140301,17031140301,2891,981,1910,0.339328951919751,0.660671048080249
17031140302,17031140302,4345,1988,2357,0.457537399309551,0.542462600690449
17031140400,17031140400,6805,4017,2788,0.590301249081558,0.409698750918442
17031140500,17031140500,3679,2220,1459,0.603424843707529,0.396575156292471
17031140800,17031140800,6825,4377,2448,0.641318681318681,0.358681318681319
17031150200,17031150200,7540,5561,1979,0.737533156498674,0.262466843501326
17031150300,17031150300,7198,5830,1368,0.809947207557655,0.190052792442345
17031150401,17031150401,4793,3818,975,0.796578343417484,0.203421656582516
17031150402,17031150402,3886,2988,898,0.768914050437468,0.231085949562532
17031150502,17031150502,4205,3237,968,0.769797859690844,0.230202140309156
17031150600,17031150600,4163,3155,1008,0.757866922892145,0.242133077107855
17031150700,17031150700,4608,3226,1382,0.700086805555556,0.299913194444444
17031150800,17031150800,5280,3622,1658,0.685984848484849,0.314015151515151
17031151001,17031151001,2819,1616,1203,0.573252926569706,0.426747073430294
17031151002,17031151002,4567,2718,1849,0.595139040945916,0.404860959054084
17031151100,17031151100,5458,3752,1706,0.687431293514108,0.312568706485892
17031151200,17031151200,3884,2910,974,0.749227600411946,0.250772399588054
17031160100,17031160100,2485,1761,724,0.708651911468813,0.291348088531187
17031160200,17031160200,3443,2587,856,0.751379610804531,0.248620389195469
17031160300,17031160300,3785,2608,1177,0.689035667107001,0.310964332892999
17031160400,17031160400,4768,3159,1609,0.662541946308725,0.337458053691275
17031160502,17031160502,3550,1879,1671,0.529295774647887,0.470704225352113
17031160800,17031160800,5148,2876,2272,0.558663558663559,0.441336441336441
17031160900,17031160900,2405,1808,597,0.751767151767152,0.248232848232848
17031161200,17031161200,2930,1681,1249,0.573720136518771,0.426279863481229
17031161300,17031161300,4117,2639,1478,0.641000728685936,0.358999271314064
17031170100,17031170100,1752,1557,195,0.888698630136986,0.111301369863014
17031170200,17031170200,3892,3201,691,0.82245632065776,0.17754367934224
17031170300,17031170300,5129,4200,929,0.818873074673426,0.181126925326574
17031170400,17031170400,3870,3331,539,0.860723514211886,0.139276485788114
17031170500,17031170500,4980,4392,588,0.881927710843374,0.118072289156626
17031170700,17031170700,2980,2609,371,0.875503355704698,0.124496644295302
17031170800,17031170800,3721,3131,590,0.841440472991131,0.158559527008869
17031170900,17031170900,1713,1311,402,0.765323992994746,0.234676007005254
17031171000,17031171000,7287,5984,1303,0.821188417730204,0.178811582269796
17031171100,17031171100,4110,3047,1063,0.741362530413625,0.258637469586375
17031180100,17031180100,6156,4382,1774,0.711825860948668,0.288174139051332
17031190100,17031190100,2488,1305,1183,0.52451768488746,0.47548231511254
17031190200,17031190200,5853,3067,2786,0.524004783871519,0.475995216128481
17031190300,17031190300,5794,3783,2011,0.652916810493614,0.347083189506386
17031190401,17031190401,4257,2427,1830,0.570119802677942,0.429880197322058
17031190402,17031190402,5458,3007,2451,0.550934408208135,0.449065591791865
17031190601,17031190601,4545,2292,2253,0.504290429042904,0.495709570957096
17031190602,17031190602,5516,2828,2688,0.512690355329949,0.487309644670051
17031190701,17031190701,2955,1235,1720,0.417935702199662,0.582064297800338
17031190702,17031190702,4869,2142,2727,0.43992606284658,0.56007393715342
17031190800,17031190800,6632,3107,3525,0.468486127864897,0.531513872135102
17031190900,17031190900,2040,991,1049,0.48578431372549,0.51421568627451
17031191000,17031191000,2559,1217,1342,0.47557639703009,0.52442360296991
17031191100,17031191100,7414,3073,4341,0.414486107364446,0.585513892635554
17031191200,17031191200,3853,1438,2415,0.373215676096548,0.626784323903452
17031191302,17031191302,5034,1879,3155,0.37326181962654,0.62673818037346
17031200100,17031200100,4354,2343,2011,0.538125861276987,0.461874138723013
17031200200,17031200200,5427,2323,3104,0.428044960383269,0.571955039616731
17031210400,17031210400,3035,1860,1175,0.612850082372323,0.387149917627677
17031210501,17031210501,3900,2436,1464,0.624615384615385,0.375384615384615
17031210502,17031210502,4486,2852,1634,0.635755684351315,0.364244315648685
17031210601,17031210601,3104,1771,1333,0.57055412371134,0.42944587628866
17031210800,17031210800,1196,637,559,0.532608695652174,0.467391304347826
17031220300,17031220300,2102,1520,582,0.723120837297812,0.276879162702188
17031220400,17031220400,2495,1871,624,0.749899799599198,0.250100200400802
17031220602,17031220602,5064,3283,1781,0.648301737756714,0.351698262243286
17031220701,17031220701,3437,1751,1686,0.509455920861216,0.490544079138784
17031220702,17031220702,4060,2077,1983,0.511576354679803,0.488423645320197
17031221000,17031221000,2923,1349,1574,0.461512145056449,0.538487854943551
17031221100,17031221100,4870,2875,1995,0.590349075975359,0.409650924024641
17031222700,17031222700,2235,1154,1081,0.516331096196868,0.483668903803132
17031230200,17031230200,2107,946,1161,0.448979591836735,0.551020408163265
17031230400,17031230400,2609,1227,1382,0.470295132234573,0.529704867765427
17031230600,17031230600,6818,1705,5113,0.250073335288941,0.749926664711059
17031230700,17031230700,6364,2041,4323,0.32071024512885,0.67928975487115
17031230900,17031230900,5399,2075,3324,0.3843304315614,0.6156695684386
17031231100,17031231100,1236,134,1102,0.108414239482201,0.891585760517799
17031231200,17031231200,6095,629,5466,0.103199343724364,0.896800656275636
17031231500,17031231500,6039,195,5844,0.0322901142573274,0.967709885742673
17031240300,17031240300,1317,1165,152,0.884586180713743,0.115413819286257
17031240800,17031240800,1617,804,813,0.49721706864564,0.50278293135436
17031241300,17031241300,1857,1440,417,0.775444264943457,0.224555735056543
17031241500,17031241500,2872,2250,622,0.783426183844011,0.216573816155989
17031242200,17031242200,3590,2823,767,0.786350974930362,0.213649025069638
17031242800,17031242800,1436,1246,190,0.867688022284123,0.132311977715877
17031243000,17031243000,2204,1589,615,0.720961887477314,0.279038112522686
17031243100,17031243100,2242,1396,846,0.622658340767172,0.377341659232828
17031243200,17031243200,2170,1383,787,0.637327188940092,0.362672811059908
17031250300,17031250300,4725,512,4213,0.108359788359788,0.891640211640212
17031250400,17031250400,5887,353,5534,0.0599626295226771,0.940037370477323
17031250500,17031250500,7538,3835,3703,0.508755638100292,0.491244361899708
17031250600,17031250600,4422,130,4292,0.0293984622342831,0.970601537765717
17031251000,17031251000,1181,28,1153,0.0237087214225233,0.976291278577477
17031251200,17031251200,4196,120,4076,0.0285986653956149,0.971401334604385
17031251300,17031251300,4921,114,4807,0.0231660231660232,0.976833976833977
17031251400,17031251400,3983,205,3778,0.0514687421541552,0.948531257845845
17031251500,17031251500,4784,97,4687,0.0202759197324415,0.979724080267559
17031251800,17031251800,5112,25,5087,0.00489045383411581,0.995109546165884
17031251900,17031251900,5731,104,5627,0.0181469202582446,0.981853079741755
17031252102,17031252102,6438,29,6409,0.0045045045045045,0.995495495495496
17031260400,17031260400,1271,8,1263,0.00629425649095201,0.993705743509048
17031260900,17031260900,1480,20,1460,0.0135135135135135,0.986486486486487
17031261000,17031261000,2319,8,2311,0.00344976282880552,0.996550237171195
17031271200,17031271200,1170,40,1130,0.0341880341880342,0.965811965811966
17031271300,17031271300,1045,13,1032,0.0124401913875598,0.98755980861244
17031271500,17031271500,1397,21,1376,0.0150322118826056,0.984967788117394
17031271800,17031271800,970,19,951,0.0195876288659794,0.980412371134021
17031280100,17031280100,4872,3745,1127,0.76867816091954,0.23132183908046
17031280400,17031280400,1366,120,1246,0.0878477306002928,0.912152269399707
17031282800,17031282800,1691,858,833,0.507392075694855,0.492607924305145
17031291200,17031291200,2240,26,2214,0.0116071428571429,0.988392857142857
17031292200,17031292200,2961,67,2894,0.0226274907125971,0.977372509287403
17031300700,17031300700,5194,1876,3318,0.361185983827493,0.638814016172507
17031300900,17031300900,5050,2153,2897,0.426336633663366,0.573663366336634
17031301200,17031301200,4012,1691,2321,0.42148554336989,0.57851445663011
17031301600,17031301600,4654,2141,2513,0.460034379028792,0.539965620971208
17031301701,17031301701,4381,2199,2182,0.501940196302214,0.498059803697786
17031301801,17031301801,4005,1789,2216,0.44669163545568,0.55330836454432
17031301802,17031301802,3518,1549,1969,0.440306992609437,0.559693007390563
17031310500,17031310500,1700,712,988,0.418823529411765,0.581176470588235
17031320100,17031320100,10848,7495,3353,0.690910766961652,0.309089233038348
17031320400,17031320400,2518,1777,741,0.70571882446386,0.29428117553614
17031340300,17031340300,1786,378,1408,0.211646136618141,0.788353863381859
17031340400,17031340400,1900,330,1570,0.173684210526316,0.826315789473684
17031350100,17031350100,2144,158,1986,0.0736940298507463,0.926305970149254
17031351100,17031351100,1960,19,1941,0.00969387755102041,0.99030612244898
17031351400,17031351400,1437,33,1404,0.022964509394572,0.977035490605428
17031351500,17031351500,255,36,219,0.141176470588235,0.858823529411765
17031390100,17031390100,1268,51,1217,0.0402208201892744,0.959779179810726
17031390600,17031390600,1866,869,997,0.465702036441586,0.534297963558414
17031400300,17031400300,1567,9,1558,0.00574345883854499,0.994256541161455
17031410200,17031410200,1443,762,681,0.528066528066528,0.471933471933472
17031410500,17031410500,2557,839,1718,0.328118889323426,0.671881110676574
17031410600,17031410600,2327,1231,1096,0.529007305543618,0.470992694456382
17031410700,17031410700,2154,1261,893,0.585422469823584,0.414577530176416
17031410800,17031410800,2662,1084,1578,0.407212622088655,0.592787377911345
17031410900,17031410900,2838,1369,1469,0.482381959126145,0.517618040873855
17031411000,17031411000,3309,1763,1546,0.532789362345119,0.467210637654881
17031411100,17031411100,2132,1531,601,0.718105065666041,0.281894934333959
17031420300,17031420300,2488,865,1623,0.347668810289389,0.652331189710611
17031420400,17031420400,1329,265,1064,0.199398043641836,0.800601956358164
17031430300,17031430300,2336,20,2316,0.00856164383561644,0.991438356164384
17031430700,17031430700,2210,93,2117,0.0420814479638009,0.957918552036199
17031430800,17031430800,1763,19,1744,0.0107770845150312,0.989222915484969
17031440101,17031440101,3746,21,3725,0.00560597971169247,0.994394020288307
17031440102,17031440102,3127,11,3116,0.00351774864086984,0.99648225135913
17031440300,17031440300,4757,32,4725,0.0067269287365987,0.993273071263401
17031440600,17031440600,2080,7,2073,0.00336538461538462,0.996634615384615
17031450300,17031450300,3615,25,3590,0.00691562932226833,0.993084370677732
17031460100,17031460100,3405,358,3047,0.105139500734214,0.894860499265786
17031460200,17031460200,2385,596,1789,0.249895178197065,0.750104821802935
17031460301,17031460301,3404,457,2947,0.134253819036428,0.865746180963572
17031460500,17031460500,5789,56,5733,0.00967351874244256,0.990326481257557
17031460600,17031460600,1183,106,1077,0.0896027049873204,0.91039729501268
17031461000,17031461000,1496,298,1198,0.199197860962567,0.800802139037433
17031480100,17031480100,2033,11,2022,0.00541072306935563,0.994589276930644
17031480300,17031480300,1468,10,1458,0.00681198910081744,0.993188010899183
17031480400,17031480400,5876,58,5818,0.00987066031313819,0.990129339686862
17031480500,17031480500,3206,253,2953,0.078914535246413,0.921085464753587
17031490600,17031490600,1562,2,1560,0.00128040973111396,0.998719590268886
17031490700,17031490700,3085,6,3079,0.00194489465153971,0.99805510534846
17031490901,17031490901,3891,21,3870,0.0053970701619121,0.994602929838088
17031491300,17031491300,2886,23,2863,0.00796950796950797,0.992030492030492
17031491400,17031491400,2931,16,2915,0.00545888775162061,0.994541112248379
17031510100,17031510100,3530,1719,1811,0.486968838526912,0.513031161473088
17031510200,17031510200,2986,425,2561,0.142330877427997,0.857669122572003
17031520100,17031520100,2075,933,1142,0.449638554216867,0.550361445783133
17031520300,17031520300,6215,3279,2936,0.527594529364441,0.472405470635559
17031520400,17031520400,4090,2195,1895,0.536674816625917,0.463325183374083
17031520500,17031520500,4301,2905,1396,0.675424319925599,0.324575680074401
17031520600,17031520600,2544,1668,876,0.655660377358491,0.344339622641509
17031530300,17031530300,4273,25,4248,0.00585069038146501,0.994149309618535
17031540102,17031540102,3109,4,3105,0.00128658732711483,0.998713412672885
17031550100,17031550100,6628,4576,2052,0.690404345202173,0.309595654797827
17031550200,17031550200,2798,2116,682,0.756254467476769,0.243745532523231
17031560100,17031560100,1473,761,712,0.51663272233537,0.48336727766463
17031560200,17031560200,1721,130,1591,0.0755374782103428,0.924462521789657
17031560300,17031560300,3187,2120,1067,0.665202384687794,0.334797615312206
17031560400,17031560400,1516,978,538,0.645118733509235,0.354881266490765
17031560700,17031560700,3484,2657,827,0.762629161882893,0.237370838117107
17031560800,17031560800,5411,4456,955,0.823507669562003,0.176492330437997
17031560900,17031560900,5093,4484,609,0.880424111525623,0.119575888474377
17031561000,17031561000,5161,4563,598,0.884130982367758,0.115869017632242
17031561100,17031561100,5407,4458,949,0.824486776400962,0.175513223599038
17031570200,17031570200,1943,1174,769,0.604220277920741,0.395779722079259
17031570300,17031570300,6116,3214,2902,0.525506867233486,0.474493132766514
17031570400,17031570400,1615,838,777,0.518885448916409,0.481114551083591
17031570500,17031570500,2462,1474,988,0.598700243704305,0.401299756295695
17031580200,17031580200,3515,1525,1990,0.433854907539118,0.566145092460882
17031580400,17031580400,4795,2052,2743,0.427945776850886,0.572054223149114
17031580501,17031580501,5067,2491,2576,0.491612393921453,0.508387606078547
17031580502,17031580502,5349,2472,2877,0.462142456533932,0.537857543466068
17031580600,17031580600,5531,2717,2814,0.491231242090038,0.508768757909962
17031580700,17031580700,6137,2715,3422,0.442398566074629,0.557601433925371
17031590600,17031590600,3564,1923,1641,0.53956228956229,0.46043771043771
17031590700,17031590700,3100,1824,1276,0.588387096774194,0.411612903225806
17031600400,17031600400,3891,1334,2557,0.34284245695194,0.65715754304806
17031600600,17031600600,2738,1229,1509,0.448867786705625,0.551132213294375
17031600700,17031600700,2545,1089,1456,0.427897838899804,0.572102161100196
17031600900,17031600900,3699,1706,1993,0.461205731278724,0.538794268721276
17031610400,17031610400,2213,941,1272,0.42521464075915,0.57478535924085
17031610800,17031610800,1393,1198,195,0.860014357501795,0.139985642498205
17031611000,17031611000,1098,97,1001,0.0883424408014572,0.911657559198543
17031611200,17031611200,2824,919,1905,0.32542492917847,0.67457507082153
17031611600,17031611600,1609,152,1457,0.0944686140459913,0.905531385954009
17031611700,17031611700,1990,226,1764,0.11356783919598,0.88643216080402
17031611800,17031611800,2139,186,1953,0.0869565217391304,0.91304347826087
17031611900,17031611900,2045,153,1892,0.0748166259168704,0.92518337408313
17031620100,17031620100,4289,2212,2077,0.515737934250408,0.484262065749592
17031620200,17031620200,2223,1323,900,0.595141700404858,0.404858299595142
17031620300,17031620300,6399,3877,2522,0.605875918112205,0.394124081887795
17031620400,17031620400,5198,3019,2179,0.580800307810696,0.419199692189304
17031630200,17031630200,1931,863,1068,0.446918694976696,0.553081305023304
17031630300,17031630300,5521,2347,3174,0.425104147799312,0.574895852200688
17031630500,17031630500,6364,3100,3264,0.487115021998743,0.512884978001257
17031630800,17031630800,7107,3246,3861,0.456732798649219,0.543267201350781
17031630900,17031630900,5363,2554,2809,0.476225992914414,0.523774007085586
17031640300,17031640300,6463,5055,1408,0.782144514931147,0.217855485068853
17031640400,17031640400,3190,2700,490,0.846394984326019,0.153605015673981
17031640500,17031640500,3491,2855,636,0.817817244342595,0.182182755657405
17031640600,17031640600,3912,3028,884,0.774028629856851,0.225971370143149
17031640700,17031640700,3156,2353,803,0.745564005069709,0.254435994930291
17031640800,17031640800,1716,943,773,0.5495337995338,0.4504662004662
17031650100,17031650100,4816,2683,2133,0.557101328903654,0.442898671096346
17031650200,17031650200,7320,4428,2892,0.604918032786885,0.395081967213115
17031650301,17031650301,5711,3583,2128,0.627385746804413,0.372614253195587
17031650302,17031650302,4344,2295,2049,0.528314917127072,0.471685082872928
17031650400,17031650400,6743,3269,3474,0.484799050867566,0.515200949132434
17031650500,17031650500,4421,2416,2005,0.546482696222574,0.453517303777426
17031660302,17031660302,5527,1802,3725,0.326035824136059,0.673964175863941
17031660400,17031660400,5960,2668,3292,0.447651006711409,0.552348993288591
17031660500,17031660500,5534,2444,3090,0.441633538127936,0.558366461872064
17031660600,17031660600,6333,1102,5231,0.174009158376757,0.825990841623243
17031660700,17031660700,2366,41,2325,0.0173288250211327,0.982671174978867
17031660900,17031660900,4232,322,3910,0.0760869565217391,0.923913043478261
17031661100,17031661100,6542,1993,4549,0.304646896973403,0.695353103026597
17031670500,17031670500,1321,22,1299,0.0166540499621499,0.98334595003785
17031670600,17031670600,1650,13,1637,0.00787878787878788,0.992121212121212
17031670800,17031670800,1635,5,1630,0.00305810397553517,0.996941896024465
17031670900,17031670900,1351,3,1348,0.00222057735011103,0.997779422649889
17031671200,17031671200,1252,8,1244,0.00638977635782748,0.993610223642173
17031671300,17031671300,2688,17,2671,0.00632440476190476,0.993675595238095
17031680500,17031680500,1481,12,1469,0.00810263335584065,0.991897366644159
17031680900,17031680900,4019,28,3991,0.00696690719084349,0.993033092809157
17031681000,17031681000,3498,22,3476,0.00628930817610063,0.993710691823899
17031681400,17031681400,3247,15,3232,0.00461964890668309,0.995380351093317
17031690400,17031690400,3464,17,3447,0.00490762124711316,0.995092378752887
17031690500,17031690500,877,6,871,0.00684150513112885,0.993158494868871
17031691000,17031691000,2492,16,2476,0.00642054574638844,0.993579454253612
17031691100,17031691100,3266,28,3238,0.00857317819963258,0.991426821800367
17031700200,17031700200,6609,3226,3383,0.488122257527614,0.511877742472386
17031700301,17031700301,5728,3529,2199,0.616096368715084,0.383903631284916
17031700302,17031700302,5319,3317,2002,0.623613461176913,0.376386538823087
17031700401,17031700401,5923,1367,4556,0.230795205132534,0.769204794867466
17031700501,17031700501,7125,399,6726,0.056,0.944
17031700502,17031700502,3036,269,2767,0.0886034255599473,0.911396574440053
17031710300,17031710300,1414,3,1411,0.00212164073550212,0.997878359264498
17031710400,17031710400,5651,29,5622,0.00513183507343833,0.994868164926562
17031710800,17031710800,5338,17,5321,0.00318471337579618,0.996815286624204
17031720100,17031720100,3300,2068,1232,0.626666666666667,0.373333333333333
17031720200,17031720200,4016,1597,2419,0.397659362549801,0.602340637450199
17031720300,17031720300,3723,2488,1235,0.668278270212194,0.331721729787806
17031720400,17031720400,1924,1719,205,0.893451143451143,0.106548856548857
17031720500,17031720500,2166,2051,115,0.946906740535549,0.0530932594644506
17031720600,17031720600,1756,1401,355,0.797835990888383,0.202164009111617
17031720700,17031720700,3149,1061,2088,0.3369323594792,0.6630676405208
17031730100,17031730100,2424,9,2415,0.00371287128712871,0.996287128712871
17031730700,17031730700,2331,13,2318,0.00557700557700558,0.994422994422994
17031740100,17031740100,3048,2861,187,0.938648293963255,0.0613517060367454
17031740200,17031740200,6547,5947,600,0.908354971742783,0.0916450282572171
17031740400,17031740400,4785,4016,769,0.839289446185998,0.160710553814002
17031750100,17031750100,4147,35,4112,0.00843983602604292,0.991560163973957
17031750200,17031750200,3227,1262,1965,0.391075302138209,0.608924697861791
17031750300,17031750300,2530,2258,272,0.892490118577075,0.107509881422925
17031750400,17031750400,3009,2026,983,0.673313393153872,0.326686606846128
17031760801,17031760801,4047,2931,1116,0.724240177909563,0.275759822090437
17031760802,17031760802,2276,2158,118,0.948154657293497,0.0518453427065027
17031760803,17031760803,6236,5323,913,0.853592046183451,0.146407953816549
17031770601,17031770601,3232,2745,487,0.849319306930693,0.150680693069307
17031770602,17031770602,4956,3464,1492,0.698950766747377,0.301049233252623
17031770700,17031770700,2681,2339,342,0.872435658336442,0.127564341663558
17031770901,17031770901,4934,4383,551,0.888325901905148,0.111674098094852
17031770902,17031770902,3521,3236,285,0.919057086055098,0.0809429139449021
17031800100,17031800100,2419,2336,83,0.965688300950806,0.0343116990491938
17031800200,17031800200,6312,5865,447,0.929182509505703,0.0708174904942965
17031800300,17031800300,3501,3329,172,0.950871179662953,0.0491288203370466
17031800400,17031800400,3762,3567,195,0.948165869218501,0.0518341307814992
17031800700,17031800700,5135,4625,510,0.900681596884129,0.0993184031158715
17031800800,17031800800,2206,1921,285,0.870806890299184,0.129193109700816
17031801000,17031801000,4908,3922,986,0.799103504482478,0.200896495517522
17031801100,17031801100,4715,4299,416,0.911770943796394,0.0882290562036055
17031801200,17031801200,3547,3390,157,0.955737242740344,0.044262757259656
17031801300,17031801300,4283,3907,376,0.912211067009106,0.0877889329908942
17031801400,17031801400,2919,2366,553,0.810551558752998,0.189448441247002
17031801500,17031801500,5928,5247,681,0.885121457489879,0.114878542510121
17031801603,17031801603,3855,2338,1517,0.606485084306096,0.393514915693904
17031801605,17031801605,5599,4832,767,0.863011252009287,0.136988747990713
17031801606,17031801606,6066,5139,927,0.847181008902077,0.152818991097923
17031801607,17031801607,5287,3786,1501,0.716096084736145,0.283903915263855
17031801608,17031801608,6564,5206,1358,0.793113954905545,0.206886045094455
17031801701,17031801701,3728,3328,400,0.892703862660944,0.107296137339056
17031801800,17031801800,5619,5052,567,0.899092365189536,0.100907634810464
17031801902,17031801902,3223,2990,233,0.927707105181508,0.0722928948184921
17031802002,17031802002,5071,4326,745,0.853086176296588,0.146913823703412
17031802003,17031802003,2684,2036,648,0.758569299552906,0.241430700447094
17031802100,17031802100,3573,3336,237,0.933669185558354,0.0663308144416457
17031802300,17031802300,4840,3870,970,0.799586776859504,0.200413223140496
17031802402,17031802402,4821,3418,1403,0.708981539099772,0.291018460900228
17031802505,17031802505,6844,4200,2644,0.613676212741087,0.386323787258913
17031802506,17031802506,2508,1756,752,0.700159489633174,0.299840510366826
17031802609,17031802609,6699,3977,2722,0.593670697118973,0.406329302881027
17031802610,17031802610,1729,1435,294,0.82995951417004,0.17004048582996
17031802701,17031802701,6952,5077,1875,0.730293440736479,0.269706559263521
17031802702,17031802702,4498,3551,947,0.789461983103602,0.210538016896398
17031805201,17031805201,3406,2413,993,0.708455666470934,0.291544333529066
17031805202,17031805202,4028,3110,918,0.772095332671301,0.227904667328699
17031805301,17031805301,3496,2169,1327,0.620423340961098,0.379576659038902
17031805302,17031805302,3602,2398,1204,0.665741254858412,0.334258745141588
17031805401,17031805401,3841,3323,518,0.865139286644103,0.134860713355897
17031805501,17031805501,3400,3205,195,0.942647058823529,0.0573529411764706
17031805600,17031805600,4511,4345,166,0.963201064065617,0.0367989359343827
17031805701,17031805701,5074,4895,179,0.964722112731573,0.0352778872684273
17031805702,17031805702,2015,1869,146,0.927543424317618,0.0724565756823822
17031805801,17031805801,2400,2271,129,0.94625,0.05375
17031805802,17031805802,4926,4606,320,0.935038570848559,0.0649614291514413
17031805901,17031805901,3834,3313,521,0.864110589462702,0.135889410537298
17031806001,17031806001,5812,3052,2760,0.525120440467997,0.474879559532003
17031806002,17031806002,7550,3985,3565,0.527814569536424,0.472185430463576
17031806003,17031806003,8109,3486,4623,0.429892711801702,0.570107288198298
17031806102,17031806102,3973,3135,838,0.789076264787314,0.210923735212686
17031806103,17031806103,5238,4196,1042,0.801069110347461,0.198930889652539
17031806104,17031806104,4206,2468,1738,0.58678078934855,0.41321921065145
17031806300,17031806300,4960,4239,721,0.854637096774194,0.145362903225806
17031806400,17031806400,2494,2107,387,0.844827586206897,0.155172413793103
17031806501,17031806501,2773,1443,1330,0.520375045077533,0.479624954922467
17031806502,17031806502,4205,3097,1108,0.736504161712247,0.263495838287753
17031806600,17031806600,3490,2778,712,0.795988538681948,0.204011461318052
17031806700,17031806700,4409,3414,995,0.77432524381946,0.22567475618054
17031806802,17031806802,3300,2078,1222,0.62969696969697,0.37030303030303
17031806900,17031806900,4713,2754,1959,0.584341183959262,0.415658816040738
17031807100,17031807100,3817,2756,1061,0.722033010217448,0.277966989782552
17031807400,17031807400,6518,3674,2844,0.563669837373427,0.436330162626573
17031807500,17031807500,3189,1833,1356,0.574788334901223,0.425211665098777
17031807700,17031807700,5933,3656,2277,0.616214394067082,0.383785605932918
17031807800,17031807800,2624,1874,750,0.714176829268293,0.285823170731707
17031807900,17031807900,4074,3005,1069,0.737604320078547,0.262395679921453
17031808001,17031808001,3646,2289,1357,0.627811300054855,0.372188699945145
17031808002,17031808002,4870,3131,1739,0.642915811088296,0.357084188911704
17031808100,17031808100,3931,3467,464,0.881963876876113,0.118036123123887
17031808301,17031808301,5625,3710,1915,0.659555555555556,0.340444444444444
17031808302,17031808302,3934,2468,1466,0.627351296390442,0.372648703609558
17031808400,17031808400,4411,2913,1498,0.660394468374518,0.339605531625482
17031808500,17031808500,4073,2864,1209,0.703167198625092,0.296832801374908
17031808800,17031808800,3955,3374,581,0.853097345132743,0.146902654867257
17031809100,17031809100,3387,3027,360,0.893711248892825,0.106288751107175
17031809200,17031809200,4611,810,3801,0.175666883539362,0.824333116460638
17031809300,17031809300,4816,3401,1415,0.706187707641196,0.293812292358804
17031809400,17031809400,5804,4084,1720,0.703652653342522,0.296347346657478
17031809500,17031809500,3670,2784,886,0.75858310626703,0.24141689373297
17031809700,17031809700,3649,1648,2001,0.451630583721568,0.548369416278432
17031809900,17031809900,2855,2398,457,0.839929947460595,0.160070052539405
17031810000,17031810000,4896,3972,924,0.811274509803922,0.188725490196078
17031810200,17031810200,5739,2343,3396,0.408259278619969,0.591740721380031
17031810301,17031810301,4002,1863,2139,0.46551724137931,0.53448275862069
17031810302,17031810302,3250,1808,1442,0.556307692307692,0.443692307692308
17031810400,17031810400,5350,5069,281,0.947476635514019,0.0525233644859813
17031810501,17031810501,5049,4777,272,0.946127946127946,0.0538720538720538
17031810600,17031810600,4717,3876,841,0.821708713165147,0.178291286834853
17031810701,17031810701,4916,4106,810,0.835231895850285,0.164768104149715
17031810702,17031810702,3918,3164,754,0.807554874936192,0.192445125063808
17031810800,17031810800,5324,4694,630,0.881667918858002,0.118332081141998
17031810900,17031810900,6429,5271,1158,0.819878674755016,0.180121325244984
17031811000,17031811000,4296,3867,429,0.900139664804469,0.0998603351955307
17031811100,17031811100,6520,5727,793,0.878374233128834,0.121625766871166
17031811301,17031811301,4845,3246,1599,0.669969040247678,0.330030959752322
17031811302,17031811302,3778,2236,1542,0.591847538380095,0.408152461619905
17031811401,17031811401,4842,3692,1150,0.762494836844279,0.237505163155721
17031811402,17031811402,4433,3222,1211,0.726821565531243,0.273178434468757
17031811500,17031811500,5895,4709,1186,0.798812553011026,0.201187446988974
17031811600,17031811600,6213,5057,1156,0.813938516014808,0.186061483985192
17031811701,17031811701,3858,2320,1538,0.601347848626231,0.398652151373769
17031811900,17031811900,5738,4804,934,0.837225514116417,0.162774485883583
17031812000,17031812000,5434,4671,763,0.859587780640412,0.140412219359588
17031812100,17031812100,4560,2684,1876,0.58859649122807,0.41140350877193
17031812200,17031812200,3942,3115,827,0.790208016235413,0.209791983764587
17031812301,17031812301,3972,2683,1289,0.675478348439074,0.324521651560926
17031812302,17031812302,2818,2131,687,0.756210078069553,0.243789921930447
17031812400,17031812400,3491,3005,486,0.86078487539387,0.13921512460613
17031812500,17031812500,3375,1880,1495,0.557037037037037,0.442962962962963
17031812600,17031812600,3706,2029,1677,0.54749055585537,0.45250944414463
17031812700,17031812700,3216,2195,1021,0.682524875621891,0.317475124378109
17031812900,17031812900,4749,3697,1052,0.778479679932617,0.221520320067383
17031813000,17031813000,3873,2571,1302,0.663826491092177,0.336173508907823
17031813100,17031813100,4538,2531,2007,0.557734684883208,0.442265315116792
17031813301,17031813301,3502,1517,1985,0.433181039406054,0.566818960593946
17031813400,17031813400,7551,3769,3782,0.499139186862667,0.500860813137333
17031813500,17031813500,6994,3294,3700,0.470975121532742,0.529024878467258
17031813600,17031813600,5334,2853,2481,0.534870641169854,0.465129358830146
17031813701,17031813701,3780,1880,1900,0.497354497354497,0.502645502645503
17031813702,17031813702,4263,2129,2134,0.499413558526859,0.500586441473141
17031813801,17031813801,2893,1464,1429,0.506049083995852,0.493950916004148
17031814000,17031814000,4746,2494,2252,0.525495153813738,0.474504846186262
17031814100,17031814100,4544,2585,1959,0.568882042253521,0.431117957746479
17031814200,17031814200,7375,3486,3889,0.472677966101695,0.527322033898305
17031814400,17031814400,7654,4762,2892,0.622158348575908,0.377841651424092
17031814700,17031814700,5646,3109,2537,0.550655331207935,0.449344668792065
17031815000,17031815000,4131,2066,2065,0.500121036068748,0.499878963931252
17031815100,17031815100,4435,2791,1644,0.629312288613303,0.370687711386697
17031815200,17031815200,6967,4300,2667,0.617195349504808,0.382804650495192
17031815300,17031815300,3617,2634,983,0.728227813104783,0.271772186895217
17031815400,17031815400,5502,4089,1413,0.743184296619411,0.256815703380589
17031815500,17031815500,7989,5027,2962,0.629240205282263,0.370759794717737
17031815600,17031815600,4973,4163,810,0.837120450432335,0.162879549567665
17031815701,17031815701,3927,3539,388,0.901196842373313,0.098803157626687
17031815702,17031815702,5128,4682,446,0.913026521060842,0.0869734789391575
17031815800,17031815800,1566,1500,66,0.957854406130268,0.0421455938697318
17031815900,17031815900,4392,2266,2126,0.515938069216758,0.484061930783242
17031816000,17031816000,3330,2216,1114,0.665465465465465,0.334534534534535
17031816100,17031816100,6445,3332,3113,0.516989914662529,0.483010085337471
17031816200,17031816200,4192,2668,1524,0.636450381679389,0.363549618320611
17031816300,17031816300,4800,2832,1968,0.59,0.41
17031816401,17031816401,5142,2921,2221,0.568066900038895,0.431933099961105
17031816402,17031816402,4404,2459,1945,0.558356039963669,0.441643960036331
17031816500,17031816500,4438,2370,2068,0.534024335286165,0.465975664713835
17031816600,17031816600,4828,2196,2632,0.454846727423364,0.545153272576636
17031816700,17031816700,2809,1605,1204,0.571377714489142,0.428622285510858
17031816800,17031816800,5368,2630,2738,0.489940387481371,0.510059612518629
17031816900,17031816900,5885,1191,4694,0.202378929481733,0.797621070518267
17031817000,17031817000,5459,868,4591,0.159003480490932,0.840996519509068
17031817101,17031817101,4542,407,4135,0.0896081021576398,0.91039189784236
17031817102,17031817102,3189,182,3007,0.0570711821887739,0.942928817811226
17031817200,17031817200,4684,234,4450,0.0499573014517506,0.950042698548249
17031817400,17031817400,4204,1768,2436,0.420551855375833,0.579448144624167
17031817500,17031817500,3623,262,3361,0.0723157604195418,0.927684239580458
17031817600,17031817600,3997,338,3659,0.0845634225669252,0.915436577433075
17031817700,17031817700,4929,251,4678,0.0509231081355244,0.949076891864476
17031817900,17031817900,5632,913,4719,0.162109375,0.837890625
17031818000,17031818000,4234,1848,2386,0.43646669815777,0.563533301842229
17031818200,17031818200,4702,2869,1833,0.610165886856657,0.389834113143343
17031818300,17031818300,5826,2050,3776,0.351870923446619,0.648129076553381
17031818401,17031818401,3634,2140,1494,0.588882773802972,0.411117226197028
17031818402,17031818402,3051,2242,809,0.734841035725991,0.265158964274009
17031818500,17031818500,5682,4774,908,0.840197113692362,0.159802886307638
17031818900,17031818900,4299,3780,519,0.879274249825541,0.120725750174459
17031819000,17031819000,5117,4944,173,0.966191127613836,0.0338088723861638
17031819100,17031819100,4552,3351,1201,0.73615992970123,0.26384007029877
17031819300,17031819300,2693,2396,297,0.889714073523951,0.110285926476049
17031819400,17031819400,5538,4577,961,0.826471650415312,0.173528349584688
17031819500,17031819500,3212,2317,895,0.721357409713574,0.278642590286426
17031819600,17031819600,4010,3829,181,0.954862842892768,0.0451371571072319
17031819700,17031819700,5917,5693,224,0.962142977860402,0.0378570221395977
17031819801,17031819801,5278,5124,154,0.970822281167109,0.0291777188328912
17031819802,17031819802,2678,2586,92,0.965646004480956,0.0343539955190441
17031820101,17031820101,6937,6426,511,0.926337033299697,0.0736629667003027
17031820103,17031820103,4016,3533,483,0.879731075697211,0.120268924302789
17031820104,17031820104,4165,3656,509,0.877791116446579,0.122208883553421
17031820201,17031820201,7827,6990,837,0.893062476044461,0.106937523955539
17031820202,17031820202,3536,2750,786,0.777714932126697,0.222285067873303
17031820400,17031820400,5701,2827,2874,0.49587791615506,0.50412208384494
17031820501,17031820501,6115,5267,848,0.861324611610793,0.138675388389207
17031820502,17031820502,5150,4289,861,0.832815533980583,0.167184466019417
17031820603,17031820603,5254,4492,762,0.854967643700038,0.145032356299962
17031820604,17031820604,3839,3372,467,0.878353737952592,0.121646262047408
17031820605,17031820605,4604,1613,2991,0.350347523892268,0.649652476107732
17031820700,17031820700,6786,4601,2185,0.678013557323902,0.321986442676098
17031820800,17031820800,3626,2721,905,0.750413678985108,0.249586321014892
17031820901,17031820901,5686,4634,1052,0.814984171649666,0.185015828350334
17031820902,17031820902,5017,3822,1195,0.761809846521826,0.238190153478174
17031821002,17031821002,5593,4822,771,0.862149114965135,0.137850885034865
17031821101,17031821101,4784,3853,931,0.805392976588629,0.194607023411371
17031821102,17031821102,4047,3134,913,0.774400790709167,0.225599209290833
17031821200,17031821200,6003,1867,4136,0.311011161086124,0.688988838913876
17031821300,17031821300,5519,1976,3543,0.358035876064504,0.641964123935496
17031821600,17031821600,4393,2301,2092,0.523787844297746,0.476212155702254
17031821700,17031821700,4889,4139,750,0.846594395581919,0.153405604418081
17031821800,17031821800,5337,4069,1268,0.762413340828181,0.237586659171819
17031821900,17031821900,5233,4206,1027,0.803745461494363,0.196254538505637
17031822101,17031822101,4480,3839,641,0.856919642857143,0.143080357142857
17031822102,17031822102,4414,3256,1158,0.737652922519257,0.262347077480743
17031822200,17031822200,3703,3265,438,0.881717526330003,0.118282473669997
17031822301,17031822301,3836,3386,450,0.882690302398332,0.117309697601668
17031822302,17031822302,4484,3711,773,0.827609277430865,0.172390722569135
17031822400,17031822400,6226,5399,827,0.867169932540957,0.132830067459043
17031822500,17031822500,4455,3856,599,0.865544332210999,0.134455667789001
17031822601,17031822601,4470,4048,422,0.905592841163311,0.094407158836689
17031822602,17031822602,7061,6014,1047,0.851720719444838,0.148279280555162
17031822701,17031822701,4181,3286,895,0.785936378856733,0.214063621143267
17031822702,17031822702,3745,3091,654,0.825367156208278,0.174632843791722
17031822801,17031822801,3345,2895,450,0.865470852017937,0.134529147982063
17031822802,17031822802,3616,3348,268,0.925884955752212,0.0741150442477876
17031822900,17031822900,2042,1763,279,0.863369245837414,0.136630754162586
17031823001,17031823001,6450,5174,1276,0.802170542635659,0.197829457364341
17031823101,17031823101,4412,4014,398,0.909791477787851,0.0902085222121487
17031823102,17031823102,3641,3288,353,0.903048613018402,0.0969513869815984
17031823200,17031823200,4877,4033,844,0.826942792700431,0.173057207299569
17031823302,17031823302,5794,3257,2537,0.562133241284087,0.437866758715913
17031823303,17031823303,4519,3464,1055,0.76654127019252,0.23345872980748
17031823304,17031823304,5927,4064,1863,0.685675721275519,0.314324278724481
17031823400,17031823400,5052,2343,2709,0.463776722090261,0.536223277909739
17031823500,17031823500,4545,2707,1838,0.595599559955996,0.404400440044004
17031823602,17031823602,6267,5823,444,0.92915270464337,0.0708472953566299
17031823605,17031823605,4547,4073,474,0.895755443149329,0.104244556850671
17031823703,17031823703,7940,6782,1158,0.854156171284635,0.145843828715365
17031823705,17031823705,4618,4071,547,0.881550454742313,0.118449545257687
17031823801,17031823801,5716,5355,361,0.936843946815955,0.0631560531840448
17031823803,17031823803,6760,6243,517,0.923520710059172,0.0764792899408284
17031823901,17031823901,3519,3150,369,0.895140664961637,0.104859335038363
17031823903,17031823903,4707,4442,265,0.943700871043127,0.0562991289568727
17031823904,17031823904,4016,3829,187,0.95343625498008,0.0465637450199203
17031824105,17031824105,6845,6381,464,0.932213294375457,0.0677867056245435
17031824107,17031824107,6493,5922,571,0.912059140612968,0.0879408593870322
17031824108,17031824108,8063,6644,1419,0.824010914051842,0.175989085948158
17031824113,17031824113,6562,5934,628,0.90429747028345,0.0957025297165498
17031824114,17031824114,4709,4234,475,0.899129326820981,0.100870673179019
17031824115,17031824115,3920,3441,479,0.87780612244898,0.12219387755102
17031824117,17031824117,9868,9000,868,0.912038913660316,0.0879610863396838
17031824119,17031824119,5675,5164,511,0.909955947136564,0.0900440528634361
17031824120,17031824120,8680,7820,860,0.900921658986175,0.0990783410138248
17031824121,17031824121,3174,2940,234,0.926275992438563,0.0737240075614367
17031824122,17031824122,6423,5893,530,0.917484041725051,0.0825159582749494
17031824300,17031824300,4814,316,4498,0.0656418778562526,0.934358122143747
17031824400,17031824400,2317,1167,1150,0.503668536901165,0.496331463098835
17031824503,17031824503,6740,6135,605,0.910237388724036,0.0897626112759644
17031824505,17031824505,6869,5848,1021,0.851361187945844,0.148638812054156
17031824506,17031824506,7617,6929,688,0.909675725351188,0.0903242746488119
17031824507,17031824507,4214,3787,427,0.898671096345515,0.101328903654485
17031824601,17031824601,4394,3932,462,0.894856622667274,0.105143377332726
17031824602,17031824602,6545,5491,1054,0.838961038961039,0.161038961038961
17031824701,17031824701,3962,2904,1058,0.732963149924281,0.267036850075719
17031824702,17031824702,5607,3680,1927,0.656322454075263,0.343677545924737
17031824800,17031824800,7756,3817,3939,0.492135121196493,0.507864878803507
17031824900,17031824900,3079,748,2331,0.242936018187723,0.757063981812277
17031825200,17031825200,2009,1361,648,0.677451468392235,0.322548531607765
17031825302,17031825302,6277,5186,1091,0.826190855504222,0.173809144495778
17031825304,17031825304,4056,3592,464,0.88560157790927,0.11439842209073
17031825400,17031825400,5419,4898,521,0.903856800147629,0.0961431998523713
17031825501,17031825501,5583,659,4924,0.118036897725237,0.881963102274763
17031825503,17031825503,6608,1249,5359,0.189013317191283,0.810986682808717
17031825504,17031825504,3734,259,3475,0.0693626138189609,0.930637386181039
17031825600,17031825600,5627,868,4759,0.15425626443931,0.845743735560689
17031825700,17031825700,4206,1096,3110,0.260580123632905,0.739419876367095
17031825802,17031825802,5850,591,5259,0.101025641025641,0.898974358974359
17031825803,17031825803,5811,776,5035,0.133539838237825,0.866460161762175
17031825900,17031825900,3374,880,2494,0.26081802015412,0.73918197984588
17031826100,17031826100,6414,1934,4480,0.301527907701902,0.698472092298098
17031826201,17031826201,3596,510,3086,0.14182424916574,0.85817575083426
17031826202,17031826202,5873,1561,4312,0.265792610250298,0.734207389749702
17031826301,17031826301,3956,493,3463,0.124620829120324,0.875379170879676
17031826303,17031826303,4162,290,3872,0.0696780394041326,0.930321960595867
17031826304,17031826304,3203,173,3030,0.0540118638776147,0.945988136122385
17031826401,17031826401,4072,182,3890,0.0446954813359529,0.955304518664047
17031826600,17031826600,5540,291,5249,0.0525270758122744,0.947472924187726
17031826800,17031826800,5436,1668,3768,0.306843267108168,0.693156732891832
17031826901,17031826901,1894,57,1837,0.0300950369588173,0.969904963041183
17031827100,17031827100,2716,78,2638,0.0287187039764359,0.971281296023564
17031827200,17031827200,4140,486,3654,0.117391304347826,0.882608695652174
17031827500,17031827500,5382,999,4383,0.18561872909699,0.81438127090301
17031827801,17031827801,4998,1695,3303,0.339135654261705,0.660864345738295
17031827802,17031827802,3385,518,2867,0.153028064992614,0.846971935007386
17031827804,17031827804,3308,607,2701,0.183494558645707,0.816505441354293
17031827901,17031827901,2605,328,2277,0.125911708253359,0.874088291746641
17031827902,17031827902,4524,1866,2658,0.412466843501326,0.587533156498674
17031828000,17031828000,5147,3208,1939,0.623275694579367,0.376724305420633
17031828100,17031828100,4844,3780,1064,0.780346820809249,0.219653179190751
17031828201,17031828201,4290,2357,1933,0.549417249417249,0.450582750582751
17031828202,17031828202,4585,2511,2074,0.547655398037077,0.452344601962923
17031828300,17031828300,3264,2206,1058,0.675857843137255,0.324142156862745
17031828401,17031828401,3644,2703,941,0.741767288693743,0.258232711306257
17031828402,17031828402,3843,2002,1841,0.520947176684882,0.479052823315118
17031830500,17031830500,4660,3023,1637,0.648712446351931,0.351287553648069
17031830600,17031830600,5005,2499,2506,0.499300699300699,0.500699300699301
17031831100,17031831100,7453,4293,3160,0.57600966053938,0.42399033946062
17031831300,17031831300,1280,215,1065,0.16796875,0.83203125
17031831400,17031831400,2964,501,2463,0.169028340080972,0.830971659919028
17031831500,17031831500,4079,2364,1715,0.579553812208875,0.420446187791125
17031831700,17031831700,2075,1302,773,0.627469879518072,0.372530120481928
17031831900,17031831900,2717,2490,227,0.916451969083548,0.083548030916452
17031832000,17031832000,1798,1597,201,0.888209121245829,0.111790878754171
17031832100,17031832100,3297,2343,954,0.710646041856233,0.289353958143767
17031832500,17031832500,3606,3023,583,0.838325013865779,0.161674986134221
17031832600,17031832600,3727,3420,307,0.917628119130668,0.0823718808693319
17031832900,17031832900,2212,1471,741,0.66500904159132,0.33499095840868
17031833100,17031833100,6895,4751,2144,0.689050036258158,0.310949963741842
17031833900,17031833900,2714,621,2093,0.228813559322034,0.771186440677966
17031834200,17031834200,4944,41,4903,0.00829288025889968,0.9917071197411
17031834400,17031834400,3772,185,3587,0.0490455991516437,0.950954400848356
17031834600,17031834600,3778,35,3743,0.0092641609317099,0.99073583906829
17031834800,17031834800,1953,8,1945,0.00409626216077829,0.995903737839222
17031835000,17031835000,5778,891,4887,0.154205607476636,0.845794392523365
17031835100,17031835100,5369,2123,3246,0.395418141180853,0.604581858819147
17031835200,17031835200,2060,1404,656,0.681553398058252,0.318446601941748
17031836000,17031836000,2177,60,2117,0.0275608635737253,0.972439136426275
17031836200,17031836200,1529,1019,510,0.666448659254415,0.333551340745585
17031836800,17031836800,2661,119,2542,0.0447200300638858,0.955279969936114
17031838000,17031838000,2561,454,2107,0.177274502147599,0.822725497852401
17031838300,17031838300,1631,480,1151,0.29429797670141,0.70570202329859
17031838600,17031838600,1598,74,1524,0.0463078848560701,0.95369211514393
17031838700,17031838700,4484,54,4430,0.012042818911686,0.987957181088314
17031839000,17031839000,7311,4989,2322,0.682396389002872,0.317603610997128
17031839100,17031839100,4350,2737,1613,0.629195402298851,0.370804597701149
17031839200,17031839200,2545,269,2276,0.105697445972495,0.894302554027505
17031839700,17031839700,4326,2440,1886,0.564031437817846,0.435968562182154
17031839800,17031839800,2730,1503,1227,0.550549450549451,0.449450549450549
17031839900,17031839900,4080,2763,1317,0.677205882352941,0.322794117647059
17031840000,17031840000,2695,1435,1260,0.532467532467532,0.467532467532468
17031840100,17031840100,2935,886,2049,0.301873935264055,0.698126064735946
17031840300,17031840300,3950,1710,2240,0.432911392405063,0.567088607594937
17031840700,17031840700,4249,1707,2542,0.40174158625559,0.59825841374441
17031840800,17031840800,3716,1680,2036,0.452099031216362,0.547900968783638
17031841100,17031841100,7254,401,6853,0.0552798456024262,0.944720154397574
17031841400,17031841400,1559,53,1506,0.0339961513790892,0.966003848620911
17031841700,17031841700,1442,248,1194,0.171983356449376,0.828016643550624
17031841800,17031841800,2505,37,2468,0.0147704590818363,0.985229540918164
17031841900,17031841900,4865,2601,2264,0.534635149023638,0.465364850976362
17031842000,17031842000,2744,1059,1685,0.385932944606414,0.614067055393586
17031842200,17031842200,2603,1292,1311,0.496350364963504,0.503649635036496
17031842400,17031842400,3304,31,3273,0.00938256658595642,0.990617433414044
17031842600,17031842600,4133,2675,1458,0.647229615291556,0.352770384708444
17031842800,17031842800,7498,3642,3856,0.4857295278741,0.5142704721259
17031842900,17031842900,2341,343,1998,0.146518581802648,0.853481418197352
17031843100,17031843100,1892,111,1781,0.0586680761099366,0.941331923890063
17031843200,17031843200,2780,1387,1393,0.498920863309353,0.501079136690648
17031843500,17031843500,11309,3188,8121,0.281899372181448,0.718100627818552
17031843700,17031843700,2117,1656,461,0.782239017477563,0.217760982522437
17031843800,17031843800,2110,616,1494,0.291943127962085,0.708056872037915
17031843900,17031843900,3533,129,3404,0.0365128785734503,0.96348712142655
17097864522,17097864522,4705,4356,349,0.925823591923486,0.0741764080765144
17097864801,17097864801,5536,4872,664,0.880057803468208,0.119942196531792
17097864802,17097864802,2661,2486,175,0.93423524990605,0.0657647500939497
17097864901,17097864901,4294,4103,191,0.955519329296693,0.044480670703307
17097864903,17097864903,4829,4488,341,0.929384965831435,0.070615034168565
17097864904,17097864904,2404,2216,188,0.92179700499168,0.0782029950083195
17097865400,17097865400,4232,3605,627,0.851843100189036,0.148156899810964
17097865502,17097865502,2420,2262,158,0.934710743801653,0.0652892561983471
17097865600,17097865600,3525,3381,144,0.959148936170213,0.0408510638297872
17097865700,17097865700,5781,5380,401,0.930634838263276,0.0693651617367238
17097865801,17097865801,3084,2840,244,0.920881971465629,0.079118028534371
17097865802,17097865802,3034,2888,146,0.951878707976269,0.0481212920237311
17031010100,17031010100,4854,1810,3044,0.372888339513803,0.627111660486197
17031010501,17031010501,4091,2018,2073,0.493277927157174,0.506722072842826
17031010502,17031010502,3101,1820,1281,0.586907449209932,0.413092550790068
17031010702,17031010702,5143,2381,2762,0.462959362239938,0.537040637760062
17031020301,17031020301,4750,3965,785,0.834736842105263,0.165263157894737
17031020500,17031020500,6214,2167,4047,0.34872867718056,0.65127132281944
17031020601,17031020601,6353,3908,2445,0.6151424523847,0.3848575476153
17031030103,17031030103,1928,1150,778,0.596473029045643,0.403526970954357
17031030200,17031030200,5369,3918,1451,0.729744831439747,0.270255168560253
17031030300,17031030300,3322,1716,1606,0.516556291390728,0.483443708609272
17031030400,17031030400,2684,1818,866,0.677347242921013,0.322652757078987
17031030500,17031030500,6395,4386,2009,0.685848318999218,0.314151681000782
17031030603,17031030603,2095,1031,1064,0.492124105011933,0.507875894988067
17031030604,17031030604,2976,1592,1384,0.53494623655914,0.46505376344086
17031030900,17031030900,3028,2216,812,0.731836195508586,0.268163804491414
17031031000,17031031000,3656,2674,982,0.731400437636761,0.268599562363239
17031031100,17031031100,4402,3053,1349,0.693548387096774,0.306451612903226
17031031501,17031031501,4083,1593,2490,0.390154298310066,0.609845701689934
17031031502,17031031502,4354,1571,2783,0.360817638952687,0.639182361047313
17031031700,17031031700,6570,3811,2759,0.580060882800609,0.419939117199391
17031031800,17031031800,1820,1371,449,0.753296703296703,0.246703296703297
17031031900,17031031900,2304,1793,511,0.778211805555556,0.221788194444444
17031032100,17031032100,7052,4866,2186,0.690017016449234,0.309982983550766
17031040202,17031040202,7249,4201,3048,0.579528210787695,0.420471789212305
17031040300,17031040300,3069,1984,1085,0.646464646464647,0.353535353535353
17031040600,17031040600,2434,2034,400,0.835661462612983,0.164338537387017
17031050200,17031050200,4837,4040,797,0.835228447384743,0.164771552615257
17031050300,17031050300,2365,1982,383,0.838054968287526,0.161945031712474
17031050600,17031050600,2071,1850,221,0.893288266537904,0.106711733462096
17031050900,17031050900,1391,1167,224,0.838964773544213,0.161035226455787
17031051000,17031051000,1503,1289,214,0.857618097139055,0.142381902860945
17031051100,17031051100,1556,1367,189,0.87853470437018,0.12146529562982
17031060300,17031060300,2839,2509,330,0.883761887988728,0.116238112011272
17031060400,17031060400,3370,3036,334,0.900890207715134,0.0991097922848665
17031060900,17031060900,6867,5421,1446,0.789427697684578,0.210572302315422
17031061902,17031061902,4240,3616,624,0.852830188679245,0.147169811320755
17031062400,17031062400,1421,1306,115,0.919071076706545,0.0809289232934554
17031062800,17031062800,3506,3188,318,0.909298345693098,0.0907016543069025
17031063100,17031063100,2173,1883,290,0.866543948458352,0.133456051541648
17031063400,17031063400,2180,1874,306,0.859633027522936,0.140366972477064
17031070101,17031070101,3796,3321,475,0.874868282402529,0.125131717597471
17031070300,17031070300,3367,3025,342,0.898425898425898,0.101574101574102
17031070700,17031070700,3481,2766,715,0.794599253088193,0.205400746911807
17031071000,17031071000,4442,3809,633,0.857496623142728,0.142503376857272
17031071300,17031071300,3513,3148,365,0.896100199259892,0.103899800740108
17031071600,17031071600,1783,1543,240,0.865395401009534,0.134604598990466
17031071700,17031071700,1652,1330,322,0.805084745762712,0.194915254237288
17031080201,17031080201,3287,2941,346,0.894736842105263,0.105263157894737
17031080400,17031080400,4317,1545,2772,0.357887421820709,0.642112578179291
17031081600,17031081600,3545,2811,734,0.792947813822285,0.207052186177715
17031100300,17031100300,6177,5704,473,0.923425611138093,0.076574388861907
17031110100,17031110100,5254,4294,960,0.817282070803198,0.182717929196802
17031110400,17031110400,4352,3504,848,0.805147058823529,0.194852941176471
17031140100,17031140100,3729,1808,1921,0.484848484848485,0.515151515151515
17031140200,17031140200,5965,3086,2879,0.517351215423303,0.482648784576697
17031140601,17031140601,2786,1353,1433,0.485642498205312,0.514357501794688
17031140602,17031140602,5397,2405,2992,0.445617935890309,0.554382064109691
17031140701,17031140701,2933,1421,1512,0.484486873508353,0.515513126491647
17031140702,17031140702,6187,2872,3315,0.464199127202198,0.535800872797802
17031150501,17031150501,3648,2973,675,0.814967105263158,0.185032894736842
17031160501,17031160501,4188,2060,2128,0.491881566380134,0.508118433619866
17031160601,17031160601,3490,2195,1295,0.628939828080229,0.371060171919771
17031160602,17031160602,3589,2300,1289,0.64084703259961,0.35915296740039
17031160700,17031160700,5893,3351,2542,0.568640760223995,0.431359239776005
17031161000,17031161000,1707,1362,345,0.797891036906854,0.202108963093146
17031161100,17031161100,1861,1486,375,0.798495432563138,0.201504567436862
17031170600,17031170600,2498,2215,283,0.886709367493995,0.113290632506005
17031191301,17031191301,5397,2045,3352,0.378914211599036,0.621085788400964
17031200300,17031200300,2209,863,1346,0.390674513354459,0.609325486645541
17031200401,17031200401,3603,1578,2025,0.43796835970025,0.56203164029975
17031200402,17031200402,4396,1542,2854,0.350773430391265,0.649226569608735
17031210100,17031210100,4028,2406,1622,0.597318768619662,0.402681231380338
17031210602,17031210602,4683,2725,1958,0.581891949604954,0.418108050395046
17031210700,17031210700,4309,2648,1661,0.614527732652588,0.385472267347412
17031210900,17031210900,3068,1878,1190,0.612125162972621,0.387874837027379
17031220500,17031220500,2626,1874,752,0.713632901751714,0.286367098248286
17031220601,17031220601,1766,1097,669,0.621177802944507,0.378822197055493
17031220901,17031220901,3498,1525,1973,0.435963407661521,0.564036592338479
17031220902,17031220902,3371,1598,1773,0.474043310590329,0.525956689409671
17031221200,17031221200,2860,1848,1012,0.646153846153846,0.353846153846154
17031221300,17031221300,3222,2010,1212,0.623836126629423,0.376163873370577
17031221400,17031221400,3020,1855,1165,0.614238410596026,0.385761589403974
17031221500,17031221500,2829,1827,1002,0.645811240721103,0.354188759278897
17031221600,17031221600,2969,2433,536,0.819467834287639,0.180532165712361
17031222200,17031222200,1912,1622,290,0.848326359832636,0.151673640167364
17031222500,17031222500,1410,720,690,0.51063829787234,0.48936170212766
17031222600,17031222600,1602,906,696,0.565543071161049,0.434456928838951
17031222800,17031222800,1074,415,659,0.386405959031657,0.613594040968343
17031222900,17031222900,1244,504,740,0.405144694533762,0.594855305466238
17031230100,17031230100,1623,734,889,0.452248921749846,0.547751078250154
17031230300,17031230300,1024,397,627,0.3876953125,0.6123046875
17031230500,17031230500,3570,1267,2303,0.354901960784314,0.645098039215686
17031230800,17031230800,1314,590,724,0.449010654490107,0.550989345509894
17031240200,17031240200,1452,1212,240,0.834710743801653,0.165289256198347
17031240500,17031240500,2251,1937,314,0.860506441581519,0.139493558418481
17031240600,17031240600,1457,1027,430,0.70487302676733,0.29512697323267
17031240700,17031240700,1535,786,749,0.512052117263844,0.487947882736156
17031240900,17031240900,1182,539,643,0.456006768189509,0.543993231810491
17031241000,17031241000,2047,934,1113,0.456277479237909,0.543722520762091
17031241100,17031241100,3682,1999,1683,0.542911461162412,0.457088538837588
17031241200,17031241200,1696,1214,482,0.715801886792453,0.284198113207547
17031241400,17031241400,4595,3699,896,0.805005440696409,0.194994559303591
17031241600,17031241600,3477,2466,1011,0.70923209663503,0.29076790336497
17031242000,17031242000,4565,2659,1906,0.582475355969332,0.417524644030668
17031242100,17031242100,3648,2751,897,0.754111842105263,0.245888157894737
17031242300,17031242300,3240,2802,438,0.864814814814815,0.135185185185185
17031242400,17031242400,2764,2488,276,0.900144717800289,0.0998552821997105
17031242500,17031242500,3438,2473,965,0.719313554392088,0.280686445607912
17031242600,17031242600,5831,3519,2312,0.603498542274053,0.396501457725947
17031242700,17031242700,2029,826,1203,0.407097092163627,0.592902907836373
17031242900,17031242900,1670,1343,327,0.804191616766467,0.195808383233533
17031243300,17031243300,2386,1831,555,0.767393126571668,0.232606873428332
17031243400,17031243400,3001,1849,1152,0.616127957347551,0.383872042652449
17031243500,17031243500,2937,2137,800,0.727613210759278,0.272386789240722
17031250200,17031250200,2669,529,2140,0.19820157362308,0.80179842637692
17031250700,17031250700,6098,197,5901,0.0323056739914726,0.967694326008527
17031250800,17031250800,2488,110,2378,0.0442122186495177,0.955787781350482
17031251100,17031251100,4302,82,4220,0.0190609019060902,0.98093909809391
17031251600,17031251600,3649,53,3596,0.0145245272677446,0.985475472732255
17031251700,17031251700,1495,56,1439,0.0374581939799331,0.962541806020067
17031252000,17031252000,5719,102,5617,0.0178352858891415,0.982164714110859
17031252101,17031252101,1370,29,1341,0.0211678832116788,0.978832116788321
17031252201,17031252201,2953,71,2882,0.0240433457500847,0.975956654249915
17031252202,17031252202,4609,31,4578,0.00672597092644825,0.993274029073552
17031260100,17031260100,1248,21,1227,0.0168269230769231,0.983173076923077
17031260200,17031260200,1136,22,1114,0.0193661971830986,0.980633802816901
17031260300,17031260300,1564,14,1550,0.00895140664961637,0.991048593350384
17031260500,17031260500,1934,11,1923,0.00568769389865564,0.994312306101344
17031260600,17031260600,2478,26,2452,0.0104923325262308,0.989507667473769
17031260700,17031260700,2032,16,2016,0.0078740157480315,0.992125984251969
17031260800,17031260800,2539,56,2483,0.0220559275305238,0.977944072469476
17031270500,17031270500,1689,21,1668,0.0124333925399645,0.987566607460036
17031271400,17031271400,1527,42,1485,0.0275049115913556,0.972495088408644
17031280800,17031280800,755,29,726,0.0384105960264901,0.96158940397351
17031280900,17031280900,942,57,885,0.0605095541401274,0.939490445859873
17031281900,17031281900,4844,2691,2153,0.555532617671346,0.444467382328654
17031282700,17031282700,2349,632,1717,0.269050659855258,0.730949340144742
17031283100,17031283100,2703,973,1730,0.359970403255642,0.640029596744358
17031283200,17031283200,1664,744,920,0.447115384615385,0.552884615384615
17031283800,17031283800,3688,1222,2466,0.331344902386117,0.668655097613883
17031290900,17031290900,4530,85,4445,0.0187637969094923,0.981236203090508
17031291600,17031291600,1055,327,728,0.309952606635071,0.690047393364929
17031292400,17031292400,2268,40,2228,0.017636684303351,0.982363315696649
17031292500,17031292500,4140,37,4103,0.00893719806763285,0.991062801932367
17031300500,17031300500,3257,1203,2054,0.369358305188824,0.630641694811176
17031300600,17031300600,3212,1215,1997,0.37826899128269,0.62173100871731
17031300800,17031300800,4610,1756,2854,0.380911062906724,0.619088937093276
17031301100,17031301100,2617,1165,1452,0.445166220863584,0.554833779136416
17031301702,17031301702,4045,2113,1932,0.522373300370828,0.477626699629172
17031301803,17031301803,5357,2653,2704,0.495239873063282,0.504760126936718
17031310200,17031310200,1336,782,554,0.585329341317365,0.414670658682635
17031310300,17031310300,1697,830,867,0.489098408956983,0.510901591043017
17031310400,17031310400,1332,668,664,0.501501501501502,0.498498498498498
17031310600,17031310600,5868,2695,3173,0.459270620313565,0.540729379686435
17031310700,17031310700,1692,805,887,0.475768321513002,0.524231678486998
17031310800,17031310800,4516,2018,2498,0.446855624446413,0.553144375553587
17031310900,17031310900,5123,2200,2923,0.429435877415577,0.570564122584423
17031320600,17031320600,4256,2633,1623,0.618656015037594,0.381343984962406
17031330100,17031330100,16735,9110,7625,0.544368090827607,0.455631909172393
17031330200,17031330200,3806,1652,2154,0.434051497635313,0.565948502364687
17031340500,17031340500,1544,773,771,0.500647668393782,0.499352331606218
17031340600,17031340600,907,1,906,0.00110253583241455,0.998897464167585
17031351000,17031351000,3267,146,3121,0.0446893174165901,0.95531068258341
17031360200,17031360200,1443,13,1430,0.00900900900900901,0.990990990990991
17031380100,17031380100,1924,64,1860,0.0332640332640333,0.966735966735967
17031380200,17031380200,1680,22,1658,0.0130952380952381,0.986904761904762
17031380500,17031380500,752,3,749,0.00398936170212766,0.996010638297872
17031380700,17031380700,1243,29,1214,0.0233306516492357,0.976669348350764
17031381200,17031381200,2167,23,2144,0.010613751730503,0.989386248269497
17031381400,17031381400,1612,11,1601,0.00682382133995037,0.99317617866005
17031381500,17031381500,237,8,229,0.0337552742616034,0.966244725738397
17031381800,17031381800,1188,33,1155,0.0277777777777778,0.972222222222222
17031381900,17031381900,1295,62,1233,0.0478764478764479,0.952123552123552
17031390200,17031390200,1840,149,1691,0.0809782608695652,0.919021739130435
17031390300,17031390300,2743,77,2666,0.028071454611739,0.971928545388261
17031390400,17031390400,2934,159,2775,0.0541922290388548,0.945807770961145
17031390500,17031390500,1598,366,1232,0.229036295369212,0.770963704630788
17031390700,17031390700,5592,1480,4112,0.264663805436338,0.735336194563662
17031400400,17031400400,1955,11,1944,0.00562659846547315,0.994373401534527
17031400500,17031400500,2258,12,2246,0.00531443755535872,0.994685562444641
17031400800,17031400800,2701,9,2692,0.00333209922251018,0.99666790077749
17031410100,17031410100,1802,544,1258,0.30188679245283,0.69811320754717
17031411200,17031411200,1640,1142,498,0.696341463414634,0.303658536585366
17031420100,17031420100,1441,38,1403,0.0263705759888966,0.973629424011103
17031420200,17031420200,1723,292,1431,0.169471851421938,0.830528148578062
17031420500,17031420500,2624,32,2592,0.0121951219512195,0.98780487804878
17031420600,17031420600,2219,22,2197,0.00991437584497521,0.990085624155025
17031420700,17031420700,3261,18,3243,0.00551977920883165,0.994480220791168
17031420800,17031420800,2213,51,2162,0.0230456394035246,0.976954360596475
17031421200,17031421200,1380,3,1377,0.00217391304347826,0.997826086956522
17031430101,17031430101,3689,36,3653,0.00975874220656004,0.99024125779344
17031430102,17031430102,2963,49,2914,0.016537293283834,0.983462706716166
17031430200,17031430200,4680,103,4577,0.022008547008547,0.977991452991453
17031430400,17031430400,2892,28,2864,0.00968188105117566,0.990318118948824
17031430500,17031430500,3604,27,3577,0.00749167591564928,0.992508324084351
17031430600,17031430600,1665,39,1626,0.0234234234234234,0.976576576576577
17031430900,17031430900,1814,9,1805,0.00496141124586549,0.995038588754135
17031431200,17031431200,3078,33,3045,0.0107212475633528,0.989278752436647
17031431301,17031431301,3545,55,3490,0.0155148095909732,0.984485190409027
17031431302,17031431302,4166,54,4112,0.0129620739318291,0.987037926068171
17031431400,17031431400,6418,164,6254,0.0255531318167653,0.974446868183235
17031440201,17031440201,5060,13,5047,0.00256916996047431,0.997430830039526
17031440202,17031440202,2999,12,2987,0.00400133377792598,0.995998666222074
17031440700,17031440700,1545,10,1535,0.00647249190938511,0.993527508090615
17031440800,17031440800,1800,8,1792,0.00444444444444444,0.995555555555556
17031440900,17031440900,2610,7,2603,0.00268199233716475,0.997318007662835
17031460302,17031460302,3803,130,3673,0.0341835393110702,0.96581646068893
17031460400,17031460400,3705,57,3648,0.0153846153846154,0.984615384615385
17031460700,17031460700,3314,742,2572,0.223898611949306,0.776101388050694
17031470100,17031470100,2916,20,2896,0.00685871056241427,0.993141289437586
17031480200,17031480200,1229,6,1223,0.0048820179007323,0.995117982099268
17031490300,17031490300,2033,9,2024,0.0044269552385637,0.995573044761436
17031490400,17031490400,1059,4,1055,0.00377714825306893,0.996222851746931
17031490500,17031490500,2242,37,2205,0.0165031222123104,0.98349687778769
17031490800,17031490800,4007,30,3977,0.00748689792862491,0.992513102071375
17031490902,17031490902,5086,14,5072,0.0027526543452615,0.997247345654738
17031491000,17031491000,5247,19,5228,0.003621116828664,0.996378883171336
17031491100,17031491100,4514,35,4479,0.0077536552946389,0.992246344705361
17031491200,17031491200,2444,20,2424,0.00818330605564648,0.991816693944354
17031500100,17031500100,3644,24,3620,0.00658616904500549,0.993413830954994
17031500200,17031500200,2015,19,1996,0.00942928039702233,0.990570719602978
17031500300,17031500300,1666,743,923,0.445978391356543,0.554021608643457
17031510300,17031510300,5360,35,5325,0.00652985074626866,0.993470149253731
17031520200,17031520200,3817,1468,2349,0.38459523185748,0.61540476814252
17031530100,17031530100,2371,457,1914,0.192745676929566,0.807254323070434
17031530200,17031530200,5152,20,5132,0.00388198757763975,0.99611801242236
17031530400,17031530400,2223,24,2199,0.0107962213225371,0.989203778677463
17031530501,17031530501,5402,26,5376,0.00481303221029248,0.995186967789707
17031530502,17031530502,1667,5,1662,0.002999400119976,0.997000599880024
17031530503,17031530503,5345,25,5320,0.00467726847521048,0.99532273152479
17031530600,17031530600,3207,30,3177,0.00935453695042095,0.990645463049579
17031540101,17031540101,3373,59,3314,0.0174918470204566,0.982508152979543
17031570100,17031570100,1257,700,557,0.556881463802705,0.443118536197295
17031580100,17031580100,2989,1479,1510,0.494814319170291,0.505185680829709
17031580300,17031580300,2426,1062,1364,0.437757625721352,0.562242374278648
17031580800,17031580800,2061,913,1148,0.442988840368753,0.557011159631247
17031590500,17031590500,1672,806,866,0.482057416267943,0.517942583732057
17031610300,17031610300,5658,2214,3444,0.391304347826087,0.608695652173913
17031611100,17031611100,2922,907,2015,0.310403832991102,0.689596167008898
17031611300,17031611300,3556,1390,2166,0.390888638920135,0.609111361079865
17031611400,17031611400,4105,1612,2493,0.392691839220463,0.607308160779537
17031611500,17031611500,3567,1309,2258,0.366975049060835,0.633024950939165
17031612000,17031612000,1545,29,1516,0.0187702265372168,0.981229773462783
17031612100,17031612100,1470,39,1431,0.026530612244898,0.973469387755102
17031630100,17031630100,1156,386,770,0.333910034602076,0.666089965397924
17031630400,17031630400,7083,3347,3736,0.472539884229846,0.527460115770154
17031640100,17031640100,1211,775,436,0.639966969446738,0.360033030553262
17031660301,17031660301,1785,386,1399,0.21624649859944,0.78375350140056
17031660800,17031660800,5865,838,5027,0.142881500426257,0.857118499573743
17031661000,17031661000,5706,266,5440,0.0466175955134946,0.953382404486505
17031670100,17031670100,1516,12,1504,0.0079155672823219,0.992084432717678
17031670200,17031670200,1380,8,1372,0.00579710144927536,0.994202898550725
17031670300,17031670300,1411,34,1377,0.0240963855421687,0.975903614457831
17031670400,17031670400,1956,26,1930,0.0132924335378323,0.986707566462168
17031670700,17031670700,1491,10,1481,0.00670690811535882,0.993293091884641
17031671100,17031671100,1259,12,1247,0.00953137410643368,0.990468625893566
17031671400,17031671400,2072,31,2041,0.01496138996139,0.98503861003861
17031671500,17031671500,3221,25,3196,0.00776156473144986,0.99223843526855
17031671600,17031671600,2495,11,2484,0.00440881763527054,0.995591182364729
17031671800,17031671800,1422,10,1412,0.0070323488045007,0.992967651195499
17031671900,17031671900,1378,3,1375,0.00217706821480406,0.997822931785196
17031672000,17031672000,3735,24,3711,0.00642570281124498,0.993574297188755
17031680600,17031680600,1431,11,1420,0.0076869322152341,0.992313067784766
17031681100,17031681100,3517,11,3506,0.00312766562411146,0.996872334375889
17031681200,17031681200,2716,11,2705,0.0040500736377025,0.995949926362298
17031681300,17031681300,2936,4,2932,0.00136239782016349,0.998637602179837
17031690300,17031690300,2191,20,2171,0.00912825193975354,0.990871748060246
17031690900,17031690900,4520,12,4508,0.00265486725663717,0.997345132743363
17031691200,17031691200,2847,13,2834,0.0045662100456621,0.995433789954338
17031691300,17031691300,2448,22,2426,0.00898692810457516,0.991013071895425
17031691400,17031691400,3611,45,3566,0.0124619219052894,0.987538078094711
17031691500,17031691500,1930,25,1905,0.0129533678756477,0.987046632124352
17031700100,17031700100,3427,547,2880,0.159614823460753,0.840385176539247
17031700402,17031700402,3914,824,3090,0.210526315789474,0.789473684210526
17031710100,17031710100,1275,15,1260,0.0117647058823529,0.988235294117647
17031710200,17031710200,5049,18,5031,0.0035650623885918,0.996434937611408
17031710500,17031710500,4123,10,4113,0.00242541838467136,0.997574581615329
17031710600,17031710600,1838,2,1836,0.00108813928182807,0.998911860718172
17031710700,17031710700,3583,11,3572,0.00307005302818867,0.996929946971811
17031710900,17031710900,2198,13,2185,0.00591446769790719,0.994085532302093
17031711000,17031711000,3475,16,3459,0.00460431654676259,0.995395683453237
17031711100,17031711100,2835,11,2824,0.00388007054673721,0.996119929453263
17031711200,17031711200,5145,12,5133,0.00233236151603499,0.997667638483965
17031711300,17031711300,1626,13,1613,0.00799507995079951,0.9920049200492
17031711400,17031711400,2654,11,2643,0.00414468726450641,0.995855312735494
17031711500,17031711500,2539,13,2526,0.0051201260338716,0.994879873966128
17031730201,17031730201,5941,14,5927,0.00235650563878135,0.997643494361219
17031730202,17031730202,3115,16,3099,0.00513643659711075,0.994863563402889
17031730300,17031730300,1166,5,1161,0.00428816466552316,0.995711835334477
17031730400,17031730400,3514,38,3476,0.0108138873079112,0.989186112692089
17031730500,17031730500,4388,22,4366,0.00501367365542388,0.994986326344576
17031730600,17031730600,3614,36,3578,0.00996126175982291,0.990038738240177
17031740300,17031740300,4713,4516,197,0.958200721408869,0.0417992785911309
17031750500,17031750500,5936,1160,4776,0.195417789757412,0.804582210242588
17031750600,17031750600,3681,25,3656,0.00679163270850312,0.993208367291497
17031770800,17031770800,5582,4459,1123,0.79881762809029,0.20118237190971
17031800500,17031800500,4901,4636,265,0.945929402162824,0.054070597837176
17031800600,17031800600,2400,2343,57,0.97625,0.02375
17031800900,17031800900,4416,2938,1478,0.665307971014493,0.334692028985507
17031801601,17031801601,4234,3670,564,0.866792631081719,0.133207368918281
17031801702,17031801702,4671,4163,508,0.89124384500107,0.10875615499893
17031801901,17031801901,4369,3634,735,0.831769283588922,0.168230716411078
17031802004,17031802004,5381,3324,2057,0.617729046645605,0.382270953354395
17031802200,17031802200,4410,4120,290,0.934240362811791,0.0657596371882087
17031802605,17031802605,6799,5670,1129,0.833946168554199,0.166053831445801
17031805402,17031805402,5095,4334,761,0.850637880274779,0.149362119725221
17031805502,17031805502,3888,3719,169,0.9565329218107,0.0434670781893004
17031805902,17031805902,6449,5409,1040,0.838734687548457,0.161265312451543
17031806004,17031806004,7604,4829,2775,0.635060494476591,0.364939505523409
17031806201,17031806201,4196,3248,948,0.774070543374643,0.225929456625357
17031806202,17031806202,4550,4000,550,0.879120879120879,0.120879120879121
17031806801,17031806801,4225,2738,1487,0.648047337278106,0.351952662721894
17031807000,17031807000,5736,3086,2650,0.538005578800558,0.461994421199442
17031807200,17031807200,5912,3391,2521,0.573579161028417,0.426420838971583
17031807300,17031807300,7191,3978,3213,0.553191489361702,0.446808510638298
17031807600,17031807600,6540,3418,3122,0.52262996941896,0.47737003058104
17031808200,17031808200,5196,3674,1522,0.707082371054657,0.292917628945343
17031808600,17031808600,2015,1856,159,0.921091811414392,0.0789081885856079
17031808702,17031808702,5504,3677,1827,0.668059593023256,0.331940406976744
17031808900,17031808900,4101,3694,407,0.900755913191904,0.0992440868080956
17031809000,17031809000,3976,3674,302,0.924044265593561,0.0759557344064387
17031809600,17031809600,3301,1295,2006,0.392305362011512,0.607694637988488
17031809800,17031809800,2717,2125,592,0.782112624217887,0.217887375782113
17031810100,17031810100,4253,2895,1358,0.680695979308723,0.319304020691277
17031810502,17031810502,5164,4623,541,0.895236250968242,0.104763749031758
17031811200,17031811200,5270,4532,738,0.859962049335863,0.140037950664137
17031811702,17031811702,5124,3419,1705,0.667252146760344,0.332747853239656
17031811800,17031811800,5399,3926,1473,0.727171698462678,0.272828301537322
17031812801,17031812801,2943,1764,1179,0.599388379204893,0.400611620795107
17031812802,17031812802,2444,1722,722,0.704582651391162,0.295417348608838
17031813200,17031813200,4251,3114,1137,0.732533521524347,0.267466478475653
17031813302,17031813302,3934,1768,2166,0.449415353329944,0.550584646670056
17031813802,17031813802,5130,2592,2538,0.505263157894737,0.494736842105263
17031813900,17031813900,6329,3206,3123,0.506557118028125,0.493442881971875
17031814300,17031814300,4884,2707,2177,0.554258804258804,0.445741195741196
17031814500,17031814500,4978,3073,1905,0.617316191241462,0.382683808758538
17031814600,17031814600,5723,3187,2536,0.5568757644592,0.4431242355408
17031814800,17031814800,6466,3970,2496,0.613980822765234,0.386019177234766
17031814900,17031814900,6181,3097,3084,0.501051609771882,0.498948390228118
17031817300,17031817300,2653,171,2482,0.0644553335846212,0.935544666415379
17031818100,17031818100,2318,1727,591,0.745038826574633,0.254961173425367
17031818600,17031818600,4715,4088,627,0.867020148462354,0.132979851537646
17031818700,17031818700,3625,3264,361,0.900413793103448,0.0995862068965517
17031818800,17031818800,5556,5093,463,0.916666666666667,0.0833333333333334
17031819200,17031819200,6107,4669,1438,0.764532503684297,0.235467496315703
17031819900,17031819900,3398,3298,100,0.970570924072984,0.0294290759270159
17031820300,17031820300,5353,3559,1794,0.664860825705212,0.335139174294788
17031820606,17031820606,3650,3226,424,0.883835616438356,0.116164383561644
17031821001,17031821001,5233,4469,764,0.854003439709536,0.145996560290464
17031821401,17031821401,3338,262,3076,0.0784901138406231,0.921509886159377
17031821402,17031821402,3587,116,3471,0.0323390019514915,0.967660998048508
17031821500,17031821500,2341,66,2275,0.028193079880393,0.971806920119607
17031822000,17031822000,4349,3986,363,0.916532536215222,0.0834674637847781
17031823002,17031823002,6077,5216,861,0.858318249136087,0.141681750863913
17031823603,17031823603,2702,783,1919,0.289785344189489,0.710214655810511
17031823604,17031823604,3578,3399,179,0.949972051425377,0.0500279485746227
17031823702,17031823702,6650,5362,1288,0.806315789473684,0.193684210526316
17031823704,17031823704,4020,3666,354,0.911940298507463,0.0880597014925373
17031823805,17031823805,2953,2764,189,0.93599729089062,0.0640027091093803
17031823806,17031823806,3716,3290,426,0.885360602798708,0.114639397201292
17031824106,17031824106,7063,6418,645,0.908679031572986,0.091320968427014
17031824116,17031824116,4718,4200,518,0.890207715133531,0.109792284866469
17031824123,17031824123,7756,7021,735,0.905234657039711,0.0947653429602888
17031825000,17031825000,5103,3763,1340,0.737409367038997,0.262590632961003
17031825303,17031825303,3872,3440,432,0.888429752066116,0.111570247933884
17031825505,17031825505,5525,589,4936,0.106606334841629,0.893393665158371
17031825801,17031825801,3550,304,3246,0.0856338028169014,0.914366197183099
17031826000,17031826000,3334,714,2620,0.214157168566287,0.785842831433713
17031826402,17031826402,5132,333,4799,0.0648869836321122,0.935113016367888
17031826500,17031826500,5936,416,5520,0.0700808625336927,0.929919137466307
17031826700,17031826700,5569,213,5356,0.0382474411923146,0.961752558807685
17031826902,17031826902,1643,21,1622,0.0127814972611077,0.987218502738892
17031827000,17031827000,3624,144,3480,0.0397350993377483,0.960264900662252
17031827300,17031827300,2947,166,2781,0.0563284696301323,0.943671530369868
17031827400,17031827400,4298,166,4132,0.0386226151698464,0.961377384830154
17031827600,17031827600,3463,31,3432,0.00895177591683511,0.991048224083165
17031827700,17031827700,2902,476,2426,0.164024810475534,0.835975189524466
17031827805,17031827805,2866,587,2279,0.204815073272854,0.795184926727146
17031830700,17031830700,4247,2118,2129,0.498704968212856,0.501295031787144
17031830800,17031830800,2391,1852,539,0.774571309075701,0.225428690924299
17031830900,17031830900,2877,1940,937,0.674313521028849,0.325686478971151
17031831000,17031831000,2138,1821,317,0.851730589335828,0.148269410664172
17031831200,17031831200,5021,1933,3088,0.384983071101374,0.615016928898626
17031831600,17031831600,7270,4148,3122,0.570563961485557,0.429436038514443
17031831800,17031831800,6322,3529,2793,0.558209427396394,0.441790572603606
17031832200,17031832200,2940,2559,381,0.870408163265306,0.129591836734694
17031832300,17031832300,1870,1520,350,0.812834224598931,0.187165775401069
17031832400,17031832400,3181,2177,1004,0.684375982395473,0.315624017604527
17031833000,17031833000,2768,2113,655,0.763367052023121,0.236632947976879
17031833300,17031833300,2278,1362,916,0.597892888498683,0.402107111501317
17031834000,17031834000,3632,18,3614,0.00495594713656388,0.995044052863436
17031834300,17031834300,6570,75,6495,0.0114155251141553,0.988584474885845
17031834500,17031834500,1475,9,1466,0.00610169491525424,0.993898305084746
17031834700,17031834700,2078,18,2060,0.00866217516843118,0.991337824831569
17031834900,17031834900,2272,18,2254,0.00792253521126761,0.992077464788732
17031835500,17031835500,1677,52,1625,0.0310077519379845,0.968992248062015
17031835600,17031835600,1199,14,1185,0.0116763969974979,0.988323603002502
17031835800,17031835800,1576,42,1534,0.0266497461928934,0.973350253807107
17031835900,17031835900,3271,53,3218,0.0162029960256802,0.98379700397432
17031836100,17031836100,1761,46,1715,0.0261215218625781,0.973878478137422
17031836300,17031836300,1288,336,952,0.260869565217391,0.739130434782609
17031836400,17031836400,2979,99,2880,0.0332326283987915,0.966767371601208
17031836500,17031836500,1496,27,1469,0.018048128342246,0.981951871657754
17031836600,17031836600,2997,946,2051,0.315648982315649,0.684351017684351
17031836700,17031836700,2397,157,2240,0.0654985398414685,0.934501460158532
17031836900,17031836900,1442,109,1333,0.0755894590846047,0.924410540915395
17031837000,17031837000,2085,99,1986,0.0474820143884892,0.952517985611511
17031837100,17031837100,1819,188,1631,0.103353490929082,0.896646509070918
17031837300,17031837300,2483,150,2333,0.0604107933950866,0.939589206604913
17031837400,17031837400,2279,186,2093,0.0816147433084686,0.918385256691531
17031837800,17031837800,2796,402,2394,0.143776824034335,0.856223175965665
17031838100,17031838100,1713,412,1301,0.2405137186223,0.7594862813777
17031838200,17031838200,1578,729,849,0.461977186311787,0.538022813688213
17031838800,17031838800,3233,685,2548,0.211877513145685,0.788122486854315
17031839500,17031839500,1545,171,1374,0.110679611650485,0.889320388349515
17031839600,17031839600,1952,90,1862,0.0461065573770492,0.953893442622951
17031840200,17031840200,2338,651,1687,0.278443113772455,0.721556886227545
17031840400,17031840400,3326,1269,2057,0.381539386650631,0.618460613349369
17031841000,17031841000,849,213,636,0.250883392226148,0.749116607773852
17031841200,17031841200,5262,2340,2922,0.444697833523375,0.555302166476625
17031841300,17031841300,4463,2383,2080,0.533945776383599,0.466054223616401
17031841500,17031841500,2962,50,2912,0.0168804861580014,0.983119513841999
17031841600,17031841600,1166,52,1114,0.0445969125214408,0.955403087478559
17031842100,17031842100,6731,1239,5492,0.184073688902095,0.815926311097905
17031842300,17031842300,3244,2281,963,0.703144266337855,0.296855733662145
17031842500,17031842500,2451,7,2444,0.00285597715218278,0.997144022847817
17031843000,17031843000,2378,7,2371,0.00294365012615643,0.997056349873844
17031843300,17031843300,1228,190,1038,0.154723127035831,0.845276872964169
17031843400,17031843400,1451,78,1373,0.0537560303239145,0.946243969676085
17031843600,17031843600,2807,65,2742,0.023156394727467,0.976843605272533
17097864505,17097864505,6493,4929,1564,0.759125211766518,0.240874788233482
17097864700,17097864700,2976,2798,178,0.940188172043011,0.0598118279569892
18089010302,18089010302,3472,79,3393,0.0227534562211982,0.977246543778802
18089020100,18089020100,4750,3768,982,0.793263157894737,0.206736842105263
18089020200,18089020200,2513,2083,430,0.828889773179467,0.171110226820533
18089020400,18089020400,5554,3375,2179,0.60767014764134,0.39232985235866
18089020500,18089020500,3984,1952,2032,0.48995983935743,0.51004016064257
18089020600,18089020600,2255,849,1406,0.37649667405765,0.62350332594235
18089020700,18089020700,5183,1875,3308,0.361759598688019,0.638240401311981
18089020800,18089020800,4455,660,3795,0.148148148148148,0.851851851851852
18089020900,18089020900,4375,2475,1900,0.565714285714286,0.434285714285714
18089021000,18089021000,5183,3519,1664,0.678950414817673,0.321049585182327
18089021100,18089021100,3016,2266,750,0.75132625994695,0.24867374005305
18089021300,18089021300,3630,2279,1351,0.627823691460055,0.372176308539945
18089021400,18089021400,5175,2688,2487,0.519420289855072,0.480579710144928
18089021600,18089021600,2996,2083,913,0.695260347129506,0.304739652870494
18089021700,18089021700,4913,3144,1769,0.639934866680236,0.360065133319764
18089021800,18089021800,3696,2202,1494,0.595779220779221,0.404220779220779
18089021900,18089021900,5184,3572,1612,0.689043209876543,0.310956790123457
18089022000,18089022000,5082,2945,2137,0.579496261314443,0.420503738685557
18089030200,18089030200,1436,325,1111,0.226323119777159,0.773676880222841
18089030400,18089030400,3505,1813,1692,0.517261055634807,0.482738944365193
18089030500,18089030500,4201,2046,2155,0.487026898357534,0.512973101642466
18089030600,18089030600,5052,2738,2314,0.541963578780681,0.458036421219319
18089040200,18089040200,3523,2663,860,0.755889866590974,0.244110133409026
18089040300,18089040300,7895,6705,1190,0.849271690943635,0.150728309056365
18089040401,18089040401,5208,4688,520,0.900153609831029,0.0998463901689708
18089040600,18089040600,3759,3379,380,0.898909284384145,0.101090715615855
18089040700,18089040700,5031,4511,520,0.896640826873385,0.103359173126615
18089041001,18089041001,5525,2587,2938,0.468235294117647,0.531764705882353
18089041100,18089041100,2377,1993,384,0.838451830037863,0.161548169962137
18089041200,18089041200,2474,1956,518,0.790622473726758,0.209377526273242
18089010304,18089010304,3149,278,2871,0.0882819942838997,0.9117180057161
18089020300,18089020300,6601,4690,1911,0.710498409331919,0.289501590668081
18089021500,18089021500,2285,1559,726,0.682275711159737,0.317724288840263
18089030100,18089030100,1456,24,1432,0.0164835164835165,0.983516483516483
18089030300,18089030300,2577,230,2347,0.0892510671323244,0.910748932867676
18089030700,18089030700,2064,534,1530,0.258720930232558,0.741279069767442
18089030800,18089030800,4272,1513,2759,0.354166666666667,0.645833333333333
18089030900,18089030900,3575,1097,2478,0.306853146853147,0.693146853146853
18089031000,18089031000,1560,210,1350,0.134615384615385,0.865384615384615
18089040100,18089040100,1474,1148,326,0.778833107191316,0.221166892808684
