"GEOID","GEO.display.label","pop","pop.white","pop.not.white","pct.white","pct.not.white"
39041011411,39041011411,2901,2671,230,0.920716994139952,0.0792830058600482
39041011412,39041011412,4517,4043,474,0.895063094974541,0.104936905025459
39041011413,39041011413,6575,6053,522,0.920608365019011,0.0793916349809886
39041011421,39041011421,6785,6029,756,0.888577745025792,0.111422254974208
39041011430,39041011430,2807,2455,352,0.874599216245102,0.125400783754898
39041011520,39041011520,3568,3065,503,0.85902466367713,0.14097533632287
39041011530,39041011530,3612,2851,761,0.789313399778516,0.210686600221484
39041011540,39041011540,5547,4639,908,0.836307914187849,0.163692085812151
39041011560,39041011560,8056,7303,753,0.906529294935452,0.0934707050645481
39041011561,39041011561,4513,3563,950,0.789497008641702,0.210502991358298
39041011604,39041011604,5189,4910,279,0.946232414723453,0.0537675852765466
39041011710,39041011710,6370,5638,732,0.885086342229199,0.114913657770801
39041011730,39041011730,6999,6115,884,0.873696242320331,0.126303757679669
39041011740,39041011740,5143,4553,590,0.885280964417655,0.114719035582345
39041011750,39041011750,6184,5652,532,0.913971539456662,0.0860284605433377
39041011760,39041011760,4240,4089,151,0.96438679245283,0.0356132075471698
39041011762,39041011762,5209,4658,551,0.894221539642926,0.105778460357074
39041011900,39041011900,5002,4257,745,0.851059576169532,0.148940423830468
39045030600,39045030600,9179,7437,1742,0.81021897810219,0.18978102189781
39045032702,39045032702,7340,3644,3696,0.496457765667575,0.503542234332425
39045032900,39045032900,10344,8906,1438,0.860982211910286,0.139017788089714
39045033100,39045033100,8700,7183,1517,0.825632183908046,0.174367816091954
39049000110,39049000110,3344,3217,127,0.962021531100478,0.0379784688995215
39049000220,39049000220,3727,3536,191,0.948752347732761,0.051247652267239
39049000310,39049000310,3147,2135,1012,0.678423895773753,0.321576104226247
39049000320,39049000320,2390,1923,467,0.804602510460251,0.195397489539749
39049000330,39049000330,2314,1623,691,0.701382886776145,0.298617113223855
39049000500,39049000500,4057,3509,548,0.864924821296524,0.135075178703476
39049000600,39049000600,3780,3255,525,0.861111111111111,0.138888888888889
39049000820,39049000820,3121,1496,1625,0.479333546940083,0.520666453059917
39049000910,39049000910,3409,807,2602,0.236726312701672,0.763273687298328
39049001000,39049001000,5830,5224,606,0.896054888507719,0.103945111492281
39049001110,39049001110,3688,2987,701,0.809924078091106,0.190075921908894
39049001121,39049001121,7300,6263,1037,0.857945205479452,0.142054794520548
39049001122,39049001122,3159,2122,1037,0.671731560620449,0.328268439379551
39049001200,39049001200,4822,4328,494,0.897552882621319,0.102447117378681
39049001300,39049001300,6583,5664,919,0.860397994835182,0.139602005164818
39049001400,39049001400,1543,217,1326,0.140635126377187,0.859364873622813
39049001500,39049001500,2031,99,1932,0.0487444608567208,0.951255539143279
39049001600,39049001600,1682,477,1205,0.28359096313912,0.71640903686088
39049001700,39049001700,2704,1668,1036,0.616863905325444,0.383136094674556
39049001810,39049001810,4434,3181,1253,0.717410915651782,0.282589084348218
39049001820,39049001820,2598,2188,410,0.842186297151655,0.157813702848345
39049001902,39049001902,3410,3072,338,0.900879765395894,0.0991202346041056
39049002100,39049002100,1808,1648,160,0.911504424778761,0.088495575221239
39049002200,39049002200,1851,1455,396,0.786061588330632,0.213938411669368
39049002520,39049002520,2648,460,2188,0.173716012084592,0.826283987915408
39049002600,39049002600,4028,958,3070,0.237835153922542,0.762164846077458
39049002710,39049002710,1858,424,1434,0.228202368137783,0.771797631862218
39049002750,39049002750,2349,694,1655,0.295444870157514,0.704555129842486
39049002760,39049002760,3066,1726,1340,0.562948467058056,0.437051532941944
39049002770,39049002770,1995,541,1454,0.271177944862155,0.728822055137845
39049003000,39049003000,3105,2082,1023,0.670531400966184,0.329468599033816
39049003200,39049003200,2147,1801,346,0.83884489986027,0.16115510013973
39049004300,39049004300,5613,4554,1059,0.811330839123463,0.188669160876537
39049004500,39049004500,5154,4019,1135,0.779782693053939,0.220217306946061
39049004610,39049004610,3368,2948,420,0.875296912114014,0.124703087885986
39049004620,39049004620,2659,1911,748,0.718691237307258,0.281308762692742
39049004700,39049004700,4971,2697,2274,0.542546771273386,0.457453228726614
39049004810,39049004810,2891,2341,550,0.809754410238672,0.190245589761328
39049004820,39049004820,2589,1818,771,0.702201622247972,0.297798377752028
39049004900,39049004900,5651,3882,1769,0.686958060520262,0.313041939479738
39049005000,39049005000,5205,4060,1145,0.780019212295869,0.219980787704131
39049005100,39049005100,1928,817,1111,0.423755186721992,0.576244813278008
39049005300,39049005300,3054,674,2380,0.220694171578258,0.779305828421742
39049005620,39049005620,2542,1580,962,0.621557828481511,0.378442171518489
39049005810,39049005810,2548,2330,218,0.914442700156986,0.0855572998430141
39049005820,39049005820,2230,1973,257,0.8847533632287,0.1152466367713
39049006000,39049006000,2345,1181,1164,0.50362473347548,0.49637526652452
39049006100,39049006100,2398,1839,559,0.766889074228524,0.233110925771476
39049006230,39049006230,13127,9306,3821,0.708920545440695,0.291079454559305
39049006236,39049006236,5979,5354,625,0.895467469476501,0.104532530523499
39049006310,39049006310,4439,4160,279,0.937148006307727,0.062851993692273
39049006321,39049006321,4086,3712,374,0.908467939304944,0.0915320606950563
39049006340,39049006340,3105,2683,422,0.864090177133655,0.135909822866345
39049006352,39049006352,2985,1980,1005,0.663316582914573,0.336683417085427
39049006371,39049006371,6472,4852,1620,0.749690976514215,0.250309023485785
39049006372,39049006372,5738,4096,1642,0.713837574067619,0.286162425932381
39049006383,39049006383,8813,6972,1841,0.791104050833995,0.208895949166005
39049006384,39049006384,6194,5030,1164,0.812076202776881,0.187923797223119
39049006386,39049006386,3702,2802,900,0.756888168557536,0.243111831442464
39049006387,39049006387,5527,4501,1026,0.814365840419758,0.185634159580242
39049006393,39049006393,5239,4377,862,0.835464783355602,0.164535216644398
39049006394,39049006394,2750,2372,378,0.862545454545455,0.137454545454545
39049006395,39049006395,3673,2750,923,0.748706779199564,0.251293220800436
39049006396,39049006396,4289,3471,818,0.809279552343204,0.190720447656796
39049006600,39049006600,3903,3742,161,0.958749679733538,0.0412503202664617
39049006722,39049006722,2828,2527,301,0.893564356435644,0.106435643564356
39049006810,39049006810,2140,2055,85,0.960280373831776,0.0397196261682243
39049006910,39049006910,1530,1448,82,0.94640522875817,0.0535947712418301
39049006921,39049006921,3431,2281,1150,0.664820751967356,0.335179248032644
39049006923,39049006923,3281,2067,1214,0.629990856446205,0.370009143553795
39049006924,39049006924,3677,1975,1702,0.537122654337775,0.462877345662225
39049006931,39049006931,6249,2649,3600,0.42390782525204,0.57609217474796
39049006933,39049006933,5257,1444,3813,0.274681377211337,0.725318622788663
39049006943,39049006943,4489,2707,1782,0.603029627979505,0.396970372020495
39049006944,39049006944,4112,2918,1194,0.709630350194553,0.290369649805447
39049006945,39049006945,5353,2026,3327,0.378479357369699,0.621520642630301
39049006950,39049006950,2744,2612,132,0.951895043731778,0.0481049562682215
39049006990,39049006990,6376,4649,1727,0.729140526976161,0.270859473023839
39049007010,39049007010,3802,3014,788,0.792740662809048,0.207259337190952
39049007020,39049007020,6372,5884,488,0.923414940364093,0.0765850596359071
39049007043,39049007043,4047,3103,944,0.7667407956511,0.2332592043489
39049007044,39049007044,5614,4044,1570,0.720342002137513,0.279657997862487
39049007048,39049007048,5672,4353,1319,0.767454160789845,0.232545839210155
39049007112,39049007112,5431,2863,2568,0.527158902596207,0.472841097403793
39049007115,39049007115,5380,2427,2953,0.451115241635688,0.548884758364312
39049007132,39049007132,7422,5596,1826,0.753974669900296,0.246025330099704
39049007194,39049007194,6417,5689,728,0.886551347981923,0.113448652018077
39049007198,39049007198,2812,2281,531,0.811166429587482,0.188833570412518
39049007201,39049007201,613,577,36,0.941272430668842,0.0587275693311582
39049007202,39049007202,2915,1699,1216,0.582847341337907,0.417152658662093
39049007203,39049007203,3233,2773,460,0.857717290442314,0.142282709557686
39049007205,39049007205,3710,3197,513,0.861725067385445,0.138274932614555
39049007209,39049007209,5706,4394,1312,0.770066596565019,0.229933403434981
39049007210,39049007210,8200,7238,962,0.882682926829268,0.117317073170732
39049007396,39049007396,9839,6770,3069,0.688078056713081,0.311921943286919
39049007424,39049007424,5470,4181,1289,0.764351005484461,0.235648994515539
39049007425,39049007425,2867,2404,463,0.838507150331357,0.161492849668643
39049007427,39049007427,6030,4664,1366,0.77346600331675,0.22653399668325
39049007492,39049007492,5738,4581,1157,0.798361798536075,0.201638201463925
39049007494,39049007494,4341,3381,960,0.778852798894264,0.221147201105736
39049007520,39049007520,3321,766,2555,0.230653417645288,0.769346582354712
39049007531,39049007531,2496,863,1633,0.345753205128205,0.654246794871795
39049007532,39049007532,2080,255,1825,0.122596153846154,0.877403846153846
39049007534,39049007534,3671,661,3010,0.180059929174612,0.819940070825388
39049007550,39049007550,2871,866,2005,0.30163706025775,0.69836293974225
39049007710,39049007710,4236,2152,2084,0.508026440037772,0.491973559962228
39049007721,39049007721,5155,1786,3369,0.346459747817653,0.653540252182347
39049007722,39049007722,3210,2005,1205,0.624610591900312,0.375389408099688
39049007730,39049007730,2925,1754,1171,0.59965811965812,0.40034188034188
39049007811,39049007811,3461,3088,373,0.892227679861312,0.107772320138688
39049007812,39049007812,4094,3617,477,0.883488031265266,0.116511968734734
39049007820,39049007820,4095,2165,1930,0.528693528693529,0.471306471306471
39049007830,39049007830,2719,2152,567,0.791467451268849,0.208532548731151
39049007922,39049007922,4101,3709,392,0.904413557668861,0.0955864423311388
39049007931,39049007931,4175,3735,440,0.894610778443114,0.105389221556886
39049007933,39049007933,7626,6808,818,0.892735378966693,0.107264621033307
39049007941,39049007941,2588,2152,436,0.831530139103555,0.168469860896445
39049007951,39049007951,8386,7431,955,0.886119723348438,0.113880276651562
39049007952,39049007952,7428,6857,571,0.923128702207862,0.0768712977921379
39049007953,39049007953,6569,5421,1148,0.825239762520932,0.174760237479068
39049007954,39049007954,7659,5463,2196,0.713278495887191,0.286721504112809
39049008000,39049008000,5410,5077,333,0.938447319778189,0.0615526802218115
39049008110,39049008110,3973,3270,703,0.823055625471936,0.176944374528064
39049008141,39049008141,7575,6460,1115,0.852805280528053,0.147194719471947
39049008142,39049008142,6806,5078,1728,0.746106376726418,0.253893623273582
39049008161,39049008161,7166,5498,1668,0.767234161317332,0.232765838682668
39049008162,39049008162,9125,7264,1861,0.796054794520548,0.203945205479452
39049008163,39049008163,3518,2043,1475,0.580727686185333,0.419272313814667
39049008164,39049008164,4008,2730,1278,0.681137724550898,0.318862275449102
39049008230,39049008230,1745,740,1005,0.424068767908309,0.575931232091691
39049008241,39049008241,2772,1947,825,0.702380952380952,0.297619047619048
39049008242,39049008242,6425,4941,1484,0.769027237354086,0.230972762645914
39049008311,39049008311,4857,2957,1900,0.608812023883055,0.391187976116945
39049008312,39049008312,4805,2965,1840,0.617065556711759,0.382934443288241
39049008321,39049008321,2299,1840,459,0.80034797738147,0.19965202261853
39049008322,39049008322,4536,3758,778,0.828483245149912,0.171516754850088
39049008330,39049008330,1744,1615,129,0.926032110091743,0.0739678899082569
39049008350,39049008350,6684,3438,3246,0.514362657091562,0.485637342908438
39049008360,39049008360,6366,5179,1187,0.81354068488847,0.18645931511153
39049008370,39049008370,7384,6568,816,0.889490790899242,0.110509209100758
39049008400,39049008400,2962,2810,152,0.948683322079676,0.0513166779203241
39049008500,39049008500,4280,4040,240,0.94392523364486,0.0560747663551402
39049008720,39049008720,3459,1255,2204,0.362821624747037,0.637178375252963
39049008730,39049008730,1761,543,1218,0.308347529812606,0.691652470187394
39049008811,39049008811,1873,1582,291,0.844634276561666,0.155365723438334
39049008812,39049008812,3034,835,2199,0.275214238628873,0.724785761371127
39049008822,39049008822,4016,2781,1235,0.692480079681275,0.307519920318725
39049008825,39049008825,6296,5502,794,0.873888182973316,0.126111817026684
39049008900,39049008900,5063,4402,661,0.869444993087103,0.130555006912897
39049009000,39049009000,3257,3004,253,0.922321154436598,0.0776788455634019
39049009100,39049009100,4737,4299,438,0.907536415452818,0.0924635845471817
39049009210,39049009210,4713,1867,2846,0.396138340759601,0.603861659240399
39049009220,39049009220,2372,1708,664,0.720067453625632,0.279932546374368
39049009230,39049009230,4429,2622,1807,0.592007225107248,0.407992774892752
39049009311,39049009311,2879,1138,1741,0.39527613754776,0.60472386245224
39049009312,39049009312,2996,907,2089,0.302736982643525,0.697263017356475
39049009321,39049009321,2164,889,1275,0.410813308687616,0.589186691312384
39049009322,39049009322,3205,1254,1951,0.391263650546022,0.608736349453978
39049009325,39049009325,4598,853,3745,0.185515441496303,0.814484558503697
39049009326,39049009326,1747,532,1215,0.30452203777905,0.69547796222095
39049009337,39049009337,3857,585,3272,0.151672284158673,0.848327715841327
39049009340,39049009340,2816,1461,1355,0.518821022727273,0.481178977272727
39049009350,39049009350,2700,1169,1531,0.432962962962963,0.567037037037037
39049009361,39049009361,4770,2447,2323,0.512997903563941,0.487002096436059
39049009371,39049009371,5528,1926,3602,0.348408104196816,0.651591895803184
39049009372,39049009372,4306,1548,2758,0.359498374361356,0.640501625638644
39049009373,39049009373,5773,1696,4077,0.293781396154512,0.706218603845488
39049009374,39049009374,8056,3555,4501,0.441285998013903,0.558714001986097
39049009381,39049009381,5439,3294,2145,0.605626034197463,0.394373965802537
39049009382,39049009382,2803,2339,464,0.834463075276489,0.165536924723511
39049009383,39049009383,2273,1610,663,0.708315002199736,0.291684997800264
39049009386,39049009386,2764,1152,1612,0.416787264833575,0.583212735166425
39049009390,39049009390,5409,4117,1292,0.761138842669625,0.238861157330375
39049009410,39049009410,2874,1871,1003,0.651009046624913,0.348990953375087
39049009420,39049009420,5793,4126,1667,0.712238909028137,0.287761090971863
39049009430,39049009430,7328,4482,2846,0.611626637554585,0.388373362445415
39049009440,39049009440,4385,3698,687,0.843329532497149,0.156670467502851
39049009495,39049009495,4843,3435,1408,0.709271112946521,0.290728887053479
39049009520,39049009520,4308,3740,568,0.868152274837512,0.131847725162488
39049009590,39049009590,4732,4310,422,0.910819949281488,0.0891800507185122
39049009600,39049009600,4169,3224,945,0.773326936915327,0.226673063084673
39049009711,39049009711,4352,4008,344,0.920955882352941,0.0790441176470589
39049009712,39049009712,2523,2408,115,0.954419342053111,0.0455806579468886
39049009720,39049009720,6810,6179,631,0.907342143906021,0.0926578560939795
39049009740,39049009740,13583,12787,796,0.941397334903924,0.0586026650960759
39049009800,39049009800,6745,6514,231,0.965752409191994,0.0342475908080059
39049010000,39049010000,5388,4345,1043,0.806421677802524,0.193578322197476
39049010200,39049010200,15920,9289,6631,0.583479899497487,0.416520100502513
39049010300,39049010300,2801,2180,621,0.778293466619065,0.221706533380935
39049010400,39049010400,7499,5913,1586,0.788505134017869,0.211494865982131
39049010500,39049010500,7953,6499,1454,0.817175908462216,0.182824091537784
39049010601,39049010601,4644,3933,711,0.846899224806202,0.153100775193798
39049010602,39049010602,6239,5486,753,0.879307581343164,0.120692418656836
39049010700,39049010700,1299,1062,237,0.817551963048499,0.182448036951501
39049980000,39049980000,2,2,0,1,0
39089755900,39089755900,6882,6021,861,0.87489102005231,0.12510897994769
39089756201,39089756201,2444,1905,539,0.779459901800327,0.220540098199673
39089756202,39089756202,8021,5734,2287,0.714873457174916,0.285126542825084
39097040102,39097040102,5091,4886,205,0.95973286191318,0.0402671380868199
39041011423,39041011423,6343,5873,470,0.925902569761942,0.0740974302380577
39041011550,39041011550,8256,6917,1339,0.83781492248062,0.16218507751938
39041012100,39041012100,6408,5708,700,0.890761548064919,0.109238451935081
39041012400,39041012400,4815,3792,1023,0.787538940809969,0.212461059190031
39045032701,39045032701,4247,2997,1250,0.705674593830939,0.294325406169061
39045032800,39045032800,4291,3846,445,0.896294570030296,0.103705429969704
39045033000,39045033000,4137,3589,548,0.86753686246072,0.13246313753928
39049000120,39049000120,3162,3016,146,0.953826691967109,0.0461733080328905
39049000210,39049000210,2935,2773,162,0.944804088586031,0.0551959114139693
39049000410,39049000410,2419,2223,196,0.918974782968169,0.0810252170318313
39049000420,39049000420,3139,2937,202,0.935648295635553,0.0643517043644473
39049000710,39049000710,3102,1987,1115,0.640554480980013,0.359445519019987
39049000720,39049000720,2384,594,1790,0.249161073825503,0.750838926174497
39049000730,39049000730,3090,179,2911,0.0579288025889968,0.942071197411003
39049000810,39049000810,2540,1625,915,0.639763779527559,0.360236220472441
39049000920,39049000920,2069,431,1638,0.208313194780087,0.791686805219913
39049001901,39049001901,2031,1699,332,0.836533727227966,0.163466272772034
39049002000,39049002000,3252,2837,415,0.872386223862239,0.127613776137761
39049002300,39049002300,1453,165,1288,0.113558155540262,0.886441844459739
39049002510,39049002510,2856,373,2483,0.130602240896359,0.869397759103641
39049002730,39049002730,2104,571,1533,0.27138783269962,0.72861216730038
39049002740,39049002740,2316,1741,575,0.751727115716753,0.248272884283247
39049002780,39049002780,2423,1439,984,0.593891869583161,0.406108130416839
39049002800,39049002800,2629,277,2352,0.105363255990871,0.894636744009129
39049002900,39049002900,2368,97,2271,0.0409628378378378,0.959037162162162
39049003600,39049003600,1442,241,1201,0.167128987517337,0.832871012482663
39049003700,39049003700,3303,973,2330,0.294580684226461,0.705419315773539
39049003800,39049003800,1896,949,947,0.500527426160338,0.499472573839662
39049004000,39049004000,2941,1898,1043,0.645358721523291,0.354641278476709
39049004200,39049004200,1370,503,867,0.367153284671533,0.632846715328467
39049005200,39049005200,2584,2315,269,0.895897832817337,0.104102167182663
39049005410,39049005410,1362,92,1270,0.0675477239353891,0.932452276064611
39049005420,39049005420,2151,177,1974,0.0822873082287308,0.917712691771269
39049005500,39049005500,4228,339,3889,0.0801797540208136,0.919820245979186
39049005610,39049005610,1784,573,1211,0.321188340807175,0.678811659192825
39049005700,39049005700,3629,3294,335,0.907688068338385,0.0923119316616148
39049005900,39049005900,2546,598,1948,0.234878240377062,0.765121759622938
39049006220,39049006220,6527,5523,1004,0.846177416883714,0.153822583116286
39049006323,39049006323,3318,2974,344,0.896323086196504,0.103676913803496
39049006330,39049006330,4716,4357,359,0.923876166242579,0.0761238337574215
39049006351,39049006351,3789,3246,543,0.856690419635788,0.143309580364212
39049006353,39049006353,4462,3270,1192,0.732855221873599,0.267144778126401
39049006391,39049006391,4770,4259,511,0.892872117400419,0.107127882599581
39049006392,39049006392,4386,3905,481,0.890332877336981,0.109667122663019
39049006410,39049006410,2666,2508,158,0.940735183795949,0.059264816204051
39049006430,39049006430,4459,3962,497,0.888540031397174,0.111459968602826
39049006500,39049006500,3646,3533,113,0.969007131102578,0.0309928688974218
39049006710,39049006710,2666,2432,234,0.912228057014254,0.0877719429857464
39049006721,39049006721,3390,3219,171,0.949557522123894,0.0504424778761062
39049006821,39049006821,3327,2427,900,0.729486023444545,0.270513976555455
39049006822,39049006822,1876,1755,121,0.935501066098081,0.064498933901919
39049006932,39049006932,5996,2527,3469,0.421447631754503,0.578552368245497
39049006942,39049006942,1167,640,527,0.548414738646101,0.451585261353899
39049007041,39049007041,2062,1794,268,0.870029097963143,0.129970902036857
39049007047,39049007047,3727,2848,879,0.764153474644486,0.235846525355514
39049007113,39049007113,4918,2772,2146,0.563643757625051,0.436356242374949
39049007114,39049007114,4823,3132,1691,0.649388347501555,0.350611652498445
39049007120,39049007120,5117,4118,999,0.804768418995505,0.195231581004495
39049007193,39049007193,6316,5786,530,0.916086130462318,0.0839138695376821
39049007199,39049007199,5271,3600,1671,0.682982356289129,0.317017643710871
39049007207,39049007207,4173,3481,692,0.834172058471124,0.165827941528876
39049007393,39049007393,8742,7420,1322,0.848776023793182,0.151223976206818
39049007394,39049007394,2806,2509,297,0.894155381325731,0.105844618674269
39049007395,39049007395,11281,7260,4021,0.643559968087935,0.356440031912065
39049007426,39049007426,2823,2525,298,0.894438540559688,0.105561459440312
39049007511,39049007511,1851,162,1689,0.0875202593192869,0.912479740680713
39049007512,39049007512,4053,353,3700,0.0870959782876881,0.912904021712312
39049007533,39049007533,1569,254,1315,0.161886551943913,0.838113448056087
39049007551,39049007551,8138,1090,7048,0.13393954288523,0.86606045711477
39049007740,39049007740,1653,1359,294,0.822141560798548,0.177858439201452
39049007921,39049007921,7719,6596,1123,0.854514833527659,0.145485166472341
39049008120,39049008120,3789,2951,838,0.778833465294273,0.221166534705727
39049008132,39049008132,6619,4769,1850,0.720501586342348,0.279498413657652
39049008210,39049008210,2210,1623,587,0.734389140271493,0.265610859728507
39049008340,39049008340,5988,4534,1454,0.757181028724115,0.242818971275885
39049008380,39049008380,5417,4108,1309,0.75835333210264,0.24164666789736
39049008710,39049008710,2691,375,2316,0.139353400222965,0.860646599777035
39049008813,39049008813,2326,307,2019,0.131986242476354,0.868013757523646
39049008821,39049008821,2695,2541,154,0.942857142857143,0.0571428571428572
39049009240,39049009240,1919,1575,344,0.820739968733715,0.179260031266285
39049009250,39049009250,1889,1374,515,0.727368978295394,0.272631021704606
39049009323,39049009323,3232,725,2507,0.224319306930693,0.775680693069307
39049009331,39049009331,803,120,683,0.149439601494396,0.850560398505604
39049009332,39049009332,3100,544,2556,0.175483870967742,0.824516129032258
39049009333,39049009333,2059,351,1708,0.170471102476931,0.829528897523069
39049009334,39049009334,2810,394,2416,0.140213523131673,0.859786476868327
39049009336,39049009336,2738,1155,1583,0.421840759678598,0.578159240321402
39049009362,39049009362,6436,4712,1724,0.732131758856433,0.267868241143567
39049009384,39049009384,2595,1828,767,0.704431599229287,0.295568400770713
39049009385,39049009385,3441,2640,801,0.767218831734961,0.232781168265039
39049009450,39049009450,8864,7385,1479,0.833145306859206,0.166854693140794
39049009497,39049009497,1625,1546,79,0.951384615384615,0.0486153846153846
39049009751,39049009751,5032,4733,299,0.940580286168522,0.0594197138314785
39049009752,39049009752,6124,5398,726,0.881450032658393,0.118549967341607
39049009900,39049009900,1499,683,816,0.455637091394263,0.544362908605737
39049010100,39049010100,1020,412,608,0.403921568627451,0.596078431372549
39159050601,39159050601,4872,3900,972,0.800492610837438,0.199507389162562
