"GEOID","GEO.display.label","pop","pop.white","pop.not.white","pct.white","pct.not.white"
39017011200,39017011200,7802,7275,527,0.932453217123814,0.0675467828761855
39017011300,39017011300,5044,4513,531,0.894726407613006,0.105273592386994
39017011800,39017011800,5845,5703,142,0.975705731394354,0.0242942686056459
39017012100,39017012100,3245,3179,66,0.979661016949153,0.0203389830508475
39017012200,39017012200,3226,2942,284,0.911965282083075,0.088034717916925
39017012300,39017012300,2028,1917,111,0.945266272189349,0.0547337278106509
39017012400,39017012400,2322,2216,106,0.954349698535745,0.045650301464255
39017012500,39017012500,4812,4320,492,0.897755610972569,0.102244389027431
39017012600,39017012600,2467,2286,181,0.926631536278881,0.0733684637211187
39017012700,39017012700,2983,2764,219,0.926583975863225,0.0734160241367751
39017013100,39017013100,2105,906,1199,0.430403800475059,0.569596199524941
39017013200,39017013200,3327,2811,516,0.844905320108206,0.155094679891794
39017013300,39017013300,2134,2019,115,0.946110590440487,0.0538894095595126
39017013500,39017013500,2876,2585,291,0.898817802503477,0.101182197496523
39017013600,39017013600,5064,3936,1128,0.777251184834123,0.222748815165877
39017014000,39017014000,2687,1590,1097,0.591737997767026,0.408262002232974
39017014100,39017014100,2276,1893,383,0.831722319859402,0.168277680140598
39017014300,39017014300,4574,4475,99,0.978355924792304,0.0216440752076956
39017014400,39017014400,1882,1559,323,0.828374070138151,0.171625929861849
39017015100,39017015100,6818,6495,323,0.952625403344089,0.0473745966559108
39023002000,39023002000,2205,2127,78,0.964625850340136,0.035374149659864
39023002701,39023002701,3173,2945,228,0.92814371257485,0.0718562874251497
39023002702,39023002702,2681,2329,352,0.868705706825811,0.131294293174189
39023003002,39023003002,3574,3455,119,0.96670397313934,0.0332960268606604
39023003101,39023003101,2517,2400,117,0.953516090584029,0.0464839094159714
39023003102,39023003102,1878,1821,57,0.969648562300319,0.0303514376996805
39057200101,39057200101,2481,2124,357,0.856106408706167,0.143893591293833
39057200103,39057200103,3713,2853,860,0.768381362779424,0.231618637220576
39057200104,39057200104,6615,4646,1969,0.702343159486017,0.297656840513983
39057200300,39057200300,3907,3526,381,0.902482723317123,0.0975172766828769
39057200500,39057200500,5048,4553,495,0.901941362916006,0.0980586370839936
39057200600,39057200600,3557,3197,360,0.898791116109081,0.101208883890919
39057200700,39057200700,4520,3679,841,0.813938053097345,0.186061946902655
39057200900,39057200900,5655,5095,560,0.900972590627763,0.099027409372237
39057210100,39057210100,5501,4218,1283,0.76676967824032,0.23323032175968
39057210200,39057210200,7897,7359,538,0.931872863112574,0.0681271368874256
39057210300,39057210300,3585,3379,206,0.942538354253835,0.0574616457461645
39057210500,39057210500,5500,4911,589,0.892909090909091,0.107090909090909
39057210601,39057210601,8431,7143,1288,0.847230459020282,0.152769540979718
39057210602,39057210602,5400,4972,428,0.920740740740741,0.0792592592592593
39057210603,39057210603,5904,5219,685,0.883976964769648,0.116023035230352
39057220100,39057220100,7698,7322,376,0.951156144453105,0.0488438555468953
39057220200,39057220200,7553,6905,648,0.914206275652059,0.0857937243479412
39057230100,39057230100,2577,2501,76,0.970508343034536,0.0294916569654637
39057240100,39057240100,2787,2444,343,0.876928597057768,0.123071402942232
39057240301,39057240301,8247,7089,1158,0.859585303746817,0.140414696253183
39057240500,39057240500,4465,3822,643,0.855991041433371,0.144008958566629
39057240600,39057240600,5528,2176,3352,0.393632416787265,0.606367583212735
39057240700,39057240700,2752,2520,232,0.915697674418605,0.0843023255813954
39057280200,39057280200,1426,1306,120,0.915848527349229,0.0841514726507714
39057280300,39057280300,1832,1456,376,0.794759825327511,0.205240174672489
39109350100,39109350100,7940,7688,252,0.968261964735516,0.0317380352644836
39109355002,39109355002,1745,1670,75,0.95702005730659,0.0429799426934098
39109380100,39109380100,5802,5600,202,0.965184419165805,0.0348155808341951
39113000300,39113000300,1957,92,1865,0.0470107307102708,0.952989269289729
39113000801,39113000801,3964,830,3134,0.209384460141271,0.790615539858729
39113000802,39113000802,2383,409,1974,0.17163239613932,0.82836760386068
39113001000,39113001000,1356,167,1189,0.123156342182891,0.876843657817109
39113001100,39113001100,4245,1316,2929,0.310011778563015,0.689988221436985
39113001200,39113001200,1325,456,869,0.344150943396226,0.655849056603774
39113001501,39113001501,3866,2410,1456,0.62338334195551,0.37661665804449
39113001600,39113001600,2072,1565,507,0.75530888030888,0.24469111969112
39113001700,39113001700,763,609,154,0.798165137614679,0.201834862385321
39113001800,39113001800,6117,4718,1399,0.771293117541278,0.228706882458722
39113001900,39113001900,4456,3686,770,0.827199281867145,0.172800718132855
39113002000,39113002000,3031,2193,838,0.723523589574398,0.276476410425602
39113002200,39113002200,2903,2250,653,0.775060282466414,0.224939717533586
39113002300,39113002300,3144,2589,555,0.823473282442748,0.176526717557252
39113002500,39113002500,5063,4329,734,0.855026664033182,0.144973335966818
39113002600,39113002600,5565,4939,626,0.887511230907457,0.112488769092543
39113002800,39113002800,2160,2040,120,0.944444444444444,0.0555555555555556
39113002900,39113002900,4076,3832,244,0.940137389597645,0.0598626104023553
39113003300,39113003300,4793,4044,749,0.843730440225329,0.156269559774671
39113003403,39113003403,3481,3185,296,0.914966963516231,0.085033036483769
39113003404,39113003404,2291,1795,496,0.783500654735923,0.216499345264077
39113003800,39113003800,3231,98,3133,0.0303311668214175,0.969668833178582
39113010100,39113010100,2129,2046,83,0.961014560826679,0.0389854391733208
39113010200,39113010200,7073,6725,348,0.950798812385127,0.0492011876148735
39113020100,39113020100,2863,2596,267,0.906741180579811,0.0932588194201887
39113020200,39113020200,2893,2631,262,0.909436571033529,0.0905634289664707
39113020300,39113020300,2628,2519,109,0.958523592085236,0.041476407914764
39113020400,39113020400,6568,5995,573,0.912758830694275,0.0872411693057247
39113020500,39113020500,1427,1322,105,0.926419060967064,0.0735809390329363
39113020601,39113020601,1843,1770,73,0.960390667390125,0.0396093326098752
39113020602,39113020602,1607,1552,55,0.965774735532047,0.0342252644679527
39113020800,39113020800,2381,2256,125,0.947501049979,0.0524989500209996
39113020900,39113020900,2630,2427,203,0.922813688212928,0.0771863117870722
39113021000,39113021000,1741,1622,119,0.931648477886272,0.0683515221137277
39113021100,39113021100,3286,2959,327,0.900486914181375,0.0995130858186245
39113021200,39113021200,1735,1603,132,0.923919308357349,0.0760806916426513
39113021302,39113021302,2258,2155,103,0.954384410983171,0.0456155890168291
39113021501,39113021501,2863,2610,253,0.911631156129934,0.0883688438700664
39113021601,39113021601,2047,1907,140,0.931607230092819,0.0683927699071812
39113021602,39113021602,3359,3204,155,0.953855314081572,0.0461446859184281
39113021700,39113021700,2471,2239,232,0.906110886280858,0.0938891137191421
39113021800,39113021800,2113,1607,506,0.760530052058684,0.239469947941316
39113030200,39113030200,2496,2144,352,0.858974358974359,0.141025641025641
39113040103,39113040103,2643,2522,121,0.954218690881574,0.045781309118426
39113040201,39113040201,2811,2667,144,0.948772678762006,0.0512273212379936
39113040204,39113040204,4603,4095,508,0.889637193134912,0.110362806865088
39113040302,39113040302,5484,4793,691,0.87399708242159,0.12600291757841
39113040303,39113040303,5079,4768,311,0.938767473912187,0.0612325260878126
39113040305,39113040305,2948,2518,430,0.854138398914518,0.145861601085482
39113040306,39113040306,5237,4685,552,0.894596142829864,0.105403857170136
39113040401,39113040401,5100,4562,538,0.894509803921569,0.105490196078431
39113040403,39113040403,4140,3444,696,0.831884057971015,0.168115942028985
39113040405,39113040405,5717,4701,1016,0.822284414902921,0.177715585097079
39113050101,39113050101,4099,3397,702,0.828738716760185,0.171261283239815
39113050103,39113050103,8833,6336,2497,0.717310087173101,0.282689912826899
39113050104,39113050104,2525,2233,292,0.884356435643564,0.115643564356436
39113050105,39113050105,4592,3818,774,0.831445993031359,0.168554006968641
39113050301,39113050301,3304,3117,187,0.943401937046005,0.0565980629539952
39113050302,39113050302,5324,5063,261,0.950976709241172,0.0490232907588279
39113050303,39113050303,3932,2864,1068,0.728382502543235,0.271617497456765
39113050502,39113050502,2891,2722,169,0.941542718782428,0.0584572812175718
39113050504,39113050504,6358,5594,764,0.879836426549229,0.120163573450771
39113050600,39113050600,3835,3745,90,0.976531942633638,0.0234680573663625
39113060100,39113060100,2887,1790,1097,0.620020782819536,0.379979217180464
39113060200,39113060200,1755,1021,734,0.581766381766382,0.418233618233618
39113060300,39113060300,3757,528,3229,0.140537663029013,0.859462336970988
39113070102,39113070102,3569,881,2688,0.246847856542449,0.753152143457551
39113070201,39113070201,1571,901,670,0.573520050922979,0.426479949077021
39113070300,39113070300,2776,614,2162,0.221181556195965,0.778818443804035
39113070400,39113070400,2539,793,1746,0.312327688066168,0.687672311933832
39113070500,39113070500,4365,698,3667,0.159908361970218,0.840091638029782
39113070600,39113070600,1198,157,1041,0.131051752921536,0.868948247078464
39113070700,39113070700,3415,725,2690,0.212298682284041,0.787701317715959
39113080100,39113080100,5823,1794,4029,0.308088614116435,0.691911385883565
39113080200,39113080200,2766,1688,1078,0.610267534345625,0.389732465654375
39113080300,39113080300,2190,663,1527,0.302739726027397,0.697260273972603
39113080400,39113080400,3216,1209,2007,0.375932835820896,0.624067164179104
39113080500,39113080500,6624,4456,2168,0.672705314009662,0.327294685990338
39113080700,39113080700,2135,2077,58,0.972833723653396,0.0271662763466042
39113090302,39113090302,6296,5351,945,0.849904701397713,0.150095298602287
39113090303,39113090303,3480,2576,904,0.740229885057471,0.259770114942529
39113090304,39113090304,6583,5230,1353,0.794470606106638,0.205529393893362
39113090700,39113090700,1437,1297,140,0.902574808629088,0.0974251913709117
39113090800,39113090800,1334,1252,82,0.938530734632684,0.0614692653673163
39113090900,39113090900,3537,3298,239,0.932428611817925,0.0675713881820752
39113091000,39113091000,2550,2403,147,0.942352941176471,0.0576470588235294
39113091100,39113091100,3013,2313,700,0.767673415200797,0.232326584799203
39113100101,39113100101,6313,4719,1594,0.747505148107081,0.252494851892919
39113100102,39113100102,5787,4488,1299,0.775531363400726,0.224468636599274
39113100201,39113100201,4593,3652,941,0.79512301328108,0.20487698671892
39113100202,39113100202,2575,1933,642,0.750679611650485,0.249320388349515
39113100301,39113100301,4426,3628,798,0.819701762313601,0.180298237686399
39113100302,39113100302,3243,2680,563,0.826395312981807,0.173604687018193
39113100400,39113100400,4759,3909,850,0.821391048539609,0.178608951460391
39113110100,39113110100,1317,1275,42,0.968109339407745,0.0318906605922551
39113110202,39113110202,3047,2555,492,0.838529701345586,0.161470298654414
39113115011,39113115011,5465,5126,339,0.937968892955169,0.0620311070448307
39113115012,39113115012,5416,4739,677,0.875,0.125
39113120101,39113120101,5293,4183,1110,0.790289061023994,0.209710938976006
39113120102,39113120102,4736,3575,1161,0.754856418918919,0.245143581081081
39113120103,39113120103,3009,2064,945,0.685942173479561,0.314057826520439
39113125000,39113125000,6306,5892,414,0.934348239771646,0.065651760228354
39113125101,39113125101,7161,5850,1311,0.816925010473398,0.183074989526602
39113125102,39113125102,6262,5315,947,0.848770360907058,0.151229639092942
39113130102,39113130102,6406,6246,160,0.975023415547924,0.0249765844520762
39113140100,39113140100,5999,5853,146,0.975662610435073,0.0243373895649275
39113150100,39113150100,6335,6152,183,0.971112865035517,0.028887134964483
39113160100,39113160100,1906,1887,19,0.9900314795383,0.00996852046169994
39113165000,39113165000,6523,6360,163,0.975011497777096,0.0249885022229036
39165030101,39165030101,4390,4261,129,0.970615034168565,0.0293849658314351
39165030102,39165030102,3942,3881,61,0.984525621511923,0.0154743784880771
39165030200,39165030200,1296,1255,41,0.968364197530864,0.0316358024691358
39165030501,39165030501,3633,3473,160,0.955959262317644,0.0440407376823562
39165030503,39165030503,5517,5292,225,0.959216965742251,0.0407830342577488
39165030600,39165030600,3615,3503,112,0.969017980636238,0.0309820193637621
39165030700,39165030700,6371,5876,495,0.922304190864856,0.0776958091351436
39165030800,39165030800,6751,6506,245,0.963709080136276,0.0362909198637239
39165030900,39165030900,12449,11417,1032,0.917101775242991,0.0828982247570086
39165032501,39165032501,3560,3429,131,0.963202247191011,0.0367977528089888
39165032502,39165032502,4180,4020,160,0.961722488038278,0.0382775119617225
39017013000,39017013000,1715,759,956,0.442565597667638,0.557434402332362
39017013400,39017013400,2180,1916,264,0.878899082568807,0.121100917431193
39017013900,39017013900,2832,2737,95,0.966454802259887,0.033545197740113
39023002800,39023002800,4649,4452,197,0.95762529576253,0.0423747042374705
39023002901,39023002901,3743,3530,213,0.943093775046754,0.056906224953246
39023002902,39023002902,4477,4106,371,0.917132008041099,0.082867991958901
39023003001,39023003001,3145,3005,140,0.955484896661367,0.0445151033386327
39057200400,39057200400,2064,1797,267,0.870639534883721,0.129360465116279
39057210401,39057210401,4964,4449,515,0.896253021756648,0.103746978243352
39057210402,39057210402,5133,4662,471,0.908240794856809,0.0917592051431911
39057240200,39057240200,4699,4114,585,0.875505426686529,0.124494573313471
39057240302,39057240302,3823,3250,573,0.850117708605807,0.149882291394193
39057255000,39057255000,3364,2642,722,0.785374554102259,0.214625445897741
39109340100,39109340100,5085,5002,83,0.983677482792527,0.0163225172074729
39109345000,39109345000,4810,4689,121,0.974844074844075,0.0251559251559251
39109355001,39109355001,5868,5634,234,0.960122699386503,0.0398773006134969
39113000100,39113000100,3053,382,2671,0.125122830003275,0.874877169996725
39113000200,39113000200,2433,271,2162,0.111385121249486,0.888614878750514
39113000400,39113000400,4263,259,4004,0.0607553366174056,0.939244663382594
39113000500,39113000500,3968,705,3263,0.177671370967742,0.822328629032258
39113000600,39113000600,1840,140,1700,0.0760869565217391,0.923913043478261
39113000700,39113000700,2615,77,2538,0.0294455066921606,0.970554493307839
39113000900,39113000900,3133,773,2360,0.246728375359081,0.753271624640919
39113002400,39113002400,2469,2102,367,0.851356824625354,0.148643175374646
39113002700,39113002700,1993,1856,137,0.931259407927747,0.0687405920722529
39113003000,39113003000,2717,2542,175,0.935590725064409,0.0644092749355907
39113003100,39113003100,2703,2509,194,0.928227894931558,0.0717721050684424
39113003201,39113003201,3442,2875,567,0.835270191748983,0.164729808251017
39113003402,39113003402,3904,3568,336,0.913934426229508,0.0860655737704918
39113003500,39113003500,2381,121,2260,0.0508189836203276,0.949181016379672
39113003900,39113003900,2373,51,2322,0.0214917825537295,0.978508217446271
39113004100,39113004100,2517,60,2457,0.0238379022646007,0.976162097735399
39113004200,39113004200,2447,62,2385,0.0253371475275848,0.974662852472415
39113004300,39113004300,2036,116,1920,0.0569744597249509,0.943025540275049
39113004400,39113004400,2252,55,2197,0.0244227353463588,0.975577264653641
39113004600,39113004600,1500,260,1240,0.173333333333333,0.826666666666667
39113020700,39113020700,3139,2932,207,0.934055431666136,0.0659445683338643
39113021301,39113021301,2848,2733,115,0.959620786516854,0.0403792134831461
39113021400,39113021400,2616,2441,175,0.933103975535168,0.0668960244648318
39113021502,39113021502,1598,1470,128,0.919899874843554,0.0801001251564456
39113021900,39113021900,2067,1950,117,0.943396226415094,0.0566037735849056
39113030100,39113030100,4650,3675,975,0.790322580645161,0.209677419354839
39113040101,39113040101,1880,1792,88,0.953191489361702,0.0468085106382978
39113040102,39113040102,2087,1946,141,0.93243890752276,0.0675610924772401
39113040203,39113040203,2734,2498,236,0.913679590343819,0.0863204096561814
39113040406,39113040406,6144,5308,836,0.863932291666667,0.136067708333333
39113050401,39113050401,5163,4830,333,0.935502614758861,0.0644973852411389
39113050402,39113050402,2250,2167,83,0.963111111111111,0.0368888888888889
39113050503,39113050503,6453,6045,408,0.936773593677359,0.0632264063226406
39113070101,39113070101,4175,1620,2555,0.388023952095808,0.611976047904192
39113070202,39113070202,2035,307,1728,0.150859950859951,0.849140049140049
39113080600,39113080600,1573,1508,65,0.958677685950413,0.0413223140495868
39113090600,39113090600,3556,3129,427,0.87992125984252,0.12007874015748
39113100203,39113100203,4828,3934,894,0.814830157415079,0.185169842584921
39113110201,39113110201,4614,4256,358,0.922410056350238,0.0775899436497616
39113115002,39113115002,4073,3857,216,0.946967836975203,0.0530321630247974
39113130101,39113130101,2474,2404,70,0.971705739692805,0.0282942603071948
39113165100,39113165100,2687,166,2521,0.0617789356159285,0.938221064384071
39113165200,39113165200,1669,639,1030,0.382863990413421,0.617136009586579
39165030504,39165030504,4878,4520,358,0.926609266092661,0.0733907339073391
39165031000,39165031000,8180,7969,211,0.974205378973105,0.0257946210268949
