"GEOID","GEO.display.label","pop","pop.white","pop.not.white","pct.white","pct.not.white"
"08001007802",8001007802,3758,1484,2274,0.394890899414582,0.605109100585418
"08001008000",8001008000,5742,2873,2869,0.500348310693138,0.499651689306862
"08001008100",8001008100,854,543,311,0.635831381733021,0.364168618266979
"08001008200",8001008200,5484,2964,2520,0.540481400437637,0.459518599562363
"08001008309",8001008309,3254,1937,1317,0.595267363245237,0.404732636754763
"08001008505",8001008505,6655,5281,1374,0.793538692712246,0.206461307287754
"08001008506",8001008506,5383,3848,1535,0.714843024335872,0.285156975664128
"08001008507",8001008507,6099,4904,1195,0.804066240367273,0.195933759632727
"08001008523",8001008523,7586,6458,1128,0.85130503559188,0.14869496440812
"08001008524",8001008524,7814,6620,1194,0.847197338111083,0.152802661888917
"08001008526",8001008526,6742,5840,902,0.866211806585583,0.133788193414417
"08001008529",8001008529,7446,5952,1494,0.799355358581789,0.200644641418211
"08001008533",8001008533,7650,5908,1742,0.772287581699346,0.227712418300654
"08001008534",8001008534,4283,3488,795,0.814382442213402,0.185617557786598
"08001008536",8001008536,2443,1972,471,0.807204257060991,0.192795742939009
"08001008537",8001008537,6047,4827,1220,0.798247064660162,0.201752935339838
"08001008539",8001008539,8437,6191,2246,0.733791632096717,0.266208367903283
"08001008540",8001008540,6408,5136,1272,0.801498127340824,0.198501872659176
"08001008541",8001008541,4277,3871,406,0.905073649754501,0.0949263502454992
"08001008542",8001008542,7036,5885,1151,0.836412734508243,0.163587265491757
"08001008543",8001008543,6935,5696,1239,0.821341023792358,0.178658976207642
"08001008544",8001008544,4181,3381,800,0.808658215737862,0.191341784262138
"08001008545",8001008545,6769,5898,871,0.871325158812232,0.128674841187768
"08001008546",8001008546,2912,2408,504,0.826923076923077,0.173076923076923
"08001008548",8001008548,1499,1215,284,0.81054036024016,0.18945963975984
"08001008549",8001008549,3906,3195,711,0.817972350230415,0.182027649769585
"08001008550",8001008550,7987,6550,1437,0.820082634280706,0.179917365719294
"08001008551",8001008551,571,512,59,0.896672504378284,0.103327495621716
"08001008603",8001008603,2055,1410,645,0.686131386861314,0.313868613138686
"08001008604",8001008604,4923,3474,1449,0.705667276051188,0.294332723948812
"08001008605",8001008605,3679,2797,882,0.760260940472955,0.239739059527045
"08001008606",8001008606,5931,4318,1613,0.728039116506491,0.271960883493509
"08001008705",8001008705,4921,2905,2016,0.590327169274538,0.409672830725462
"08001008706",8001008706,5436,3171,2265,0.583333333333333,0.416666666666667
"08001008709",8001008709,7656,4469,3187,0.583725182863114,0.416274817136886
"08001008801",8001008801,4752,3179,1573,0.668981481481482,0.331018518518518
"08001008802",8001008802,4075,2574,1501,0.631656441717791,0.368343558282209
"08001009001",8001009001,4645,2979,1666,0.641334768568353,0.358665231431647
"08001009101",8001009101,4112,2939,1173,0.714737354085603,0.285262645914397
"08001009103",8001009103,3462,2388,1074,0.689774696707106,0.310225303292894
"08001009104",8001009104,5200,3600,1600,0.692307692307692,0.307692307692308
"08001009202",8001009202,4242,3277,965,0.772512965582273,0.227487034417727
"08001009203",8001009203,4222,2697,1525,0.63879677877783,0.36120322122217
"08001009204",8001009204,6500,4534,1966,0.697538461538462,0.302461538461538
"08001009206",8001009206,2021,1449,572,0.716971796140525,0.283028203859475
"08001009207",8001009207,4429,3166,1263,0.714834048317905,0.285165951682095
"08001009304",8001009304,5400,3953,1447,0.732037037037037,0.267962962962963
"08001009306",8001009306,3692,2541,1151,0.688244853737812,0.311755146262188
"08001009307",8001009307,3774,2545,1229,0.674350821409645,0.325649178590355
"08001009308",8001009308,4087,2781,1306,0.680450207976511,0.319549792023489
"08001009309",8001009309,3613,2243,1370,0.620813728203709,0.379186271796291
"08001009310",8001009310,5827,3907,1920,0.670499399347863,0.329500600652137
"08001009316",8001009316,5751,4423,1328,0.769083637628239,0.230916362371761
"08001009318",8001009318,5664,3234,2430,0.570974576271186,0.429025423728814
"08001009319",8001009319,2605,1817,788,0.697504798464491,0.302495201535509
"08001009320",8001009320,2672,1746,926,0.653443113772455,0.346556886227545
"08001009321",8001009321,3782,2833,949,0.749074563722898,0.250925436277102
"08001009322",8001009322,4246,2990,1256,0.704192180876119,0.295807819123881
"08001009323",8001009323,3728,2608,1120,0.699570815450644,0.300429184549356
"08001009325",8001009325,5063,4345,718,0.85818684574363,0.14181315425637
"08001009327",8001009327,4124,3233,891,0.783947623666343,0.216052376333657
"08001009401",8001009401,4903,3626,1277,0.73954721599021,0.26045278400979
"08001009406",8001009406,4259,3427,832,0.804648978633482,0.195351021366518
"08001009407",8001009407,5227,3628,1599,0.694088387220203,0.305911612779797
"08001009408",8001009408,4260,3527,733,0.827934272300469,0.172065727699531
"08001009410",8001009410,3316,3007,309,0.906815440289505,0.0931845597104946
"08001009411",8001009411,2959,2494,465,0.842852314971274,0.157147685028726
"08001009501",8001009501,3156,2129,1027,0.674588086185044,0.325411913814956
"08001009502",8001009502,3633,2540,1093,0.699146710707404,0.300853289292596
"08001009553",8001009553,2959,2154,805,0.727948631294356,0.272051368705644
"08001009603",8001009603,5921,4510,1411,0.761695659516973,0.238304340483027
"08001009604",8001009604,4569,3524,1045,0.771284745020792,0.228715254979208
"08001009607",8001009607,4931,3219,1712,0.652808760900426,0.347191239099574
"08001009751",8001009751,3626,2456,1170,0.677330391616106,0.322669608383894
"08001009752",8001009752,3061,1958,1103,0.639660241751062,0.360339758248938
"08001015000",8001015000,2495,1858,637,0.744689378757515,0.255310621242485
"08001060000",8001060000,4747,4194,553,0.883505371813777,0.116494628186223
"08001060100",8001060100,6170,5164,1006,0.836952998379254,0.163047001620746
"08001060200",8001060200,3681,3083,598,0.837544145612605,0.162455854387395
"08001061200",8001061200,1294,1077,217,0.832302936630603,0.167697063369397
"08005004951",8005004951,1883,1221,662,0.648433351035582,0.351566648964418
"08005004952",8005004952,2301,1654,647,0.718817905258583,0.281182094741417
"08005005551",8005005551,3224,2069,1155,0.641749379652605,0.358250620347395
"08005005552",8005005552,2414,1704,710,0.705882352941177,0.294117647058823
"08005005553",8005005553,3594,2847,747,0.792153589315526,0.207846410684474
"08005005611",8005005611,4747,4328,419,0.911733726564146,0.0882662734358542
"08005005612",8005005612,3616,3252,364,0.899336283185841,0.100663716814159
"08005005614",8005005614,3146,2915,231,0.926573426573427,0.0734265734265734
"08005005619",8005005619,4574,4214,360,0.921294271972016,0.0787057280279843
"08005005623",8005005623,3547,3324,223,0.937129968987877,0.062870031012123
"08005005624",8005005624,2106,1971,135,0.935897435897436,0.0641025641025641
"08005005625",8005005625,2899,2675,224,0.922731976543636,0.0772680234563643
"08005005626",8005005626,3210,2930,280,0.912772585669782,0.0872274143302181
"08005005627",8005005627,4271,4063,208,0.95129946148443,0.0487005385155701
"08005005628",8005005628,5609,5188,421,0.924942057407738,0.0750579425922624
"08005005630",8005005630,5322,4941,381,0.928410372040586,0.0715896279594137
"08005005631",8005005631,3028,2837,191,0.936922060766182,0.0630779392338177
"08005005632",8005005632,3189,2977,212,0.933521480087802,0.0664785199121982
"08005005633",8005005633,3002,2783,219,0.927048634243837,0.0729513657561626
"08005005634",8005005634,2959,2818,141,0.952348766475161,0.0476512335248395
"08005005700",8005005700,3593,2822,771,0.785416086835513,0.214583913164487
"08005005800",8005005800,2391,2213,178,0.925554161438729,0.0744458385612714
"08005005951",8005005951,4032,3433,599,0.851438492063492,0.148561507936508
"08005005952",8005005952,3091,2606,485,0.843092850210288,0.156907149789712
"08005006000",8005006000,2693,2299,394,0.853694764203491,0.146305235796509
"08005006100",8005006100,2672,2298,374,0.860029940119761,0.139970059880239
"08005006200",8005006200,2864,2549,315,0.890013966480447,0.109986033519553
"08005006300",8005006300,2621,2353,268,0.897748950782144,0.102251049217856
"08005006400",8005006400,2975,2449,526,0.823193277310924,0.176806722689076
"08005006501",8005006501,1678,1416,262,0.843861740166865,0.156138259833135
"08005006502",8005006502,3171,2841,330,0.89593188268685,0.10406811731315
"08005006601",8005006601,5610,4306,1304,0.767557932263815,0.232442067736185
"08005006603",8005006603,3210,2925,285,0.911214953271028,0.0887850467289719
"08005006604",8005006604,3761,3209,552,0.853230523796862,0.146769476203138
"08005006704",8005006704,4239,3988,251,0.940787921679641,0.0592120783203586
"08005006705",8005006705,1748,1670,78,0.955377574370709,0.0446224256292906
"08005006706",8005006706,4720,4392,328,0.930508474576271,0.0694915254237288
"08005006707",8005006707,4530,4080,450,0.900662251655629,0.0993377483443708
"08005006709",8005006709,4882,4537,345,0.929332240884883,0.0706677591151168
"08005006711",8005006711,3869,3561,308,0.92039286637374,0.07960713362626
"08005006712",8005006712,1219,1136,83,0.931911402789172,0.0680885972108285
"08005006713",8005006713,1209,848,361,0.701406120760959,0.298593879239041
"08005006808",8005006808,5475,4916,559,0.897899543378995,0.102100456621005
"08005006815",8005006815,4057,3273,784,0.806753758935174,0.193246241064826
"08005006855",8005006855,5097,3883,1214,0.761820678830685,0.238179321169315
"08005006856",8005006856,7648,5757,1891,0.752745815899582,0.247254184100418
"08005006858",8005006858,4143,3284,859,0.792662321988897,0.207337678011103
"08005007103",8005007103,1585,1437,148,0.906624605678233,0.0933753943217666
"08005007104",8005007104,4958,3480,1478,0.701895925776523,0.298104074223477
"08005007105",8005007105,3103,2463,640,0.793747985820174,0.206252014179826
"08005007106",8005007106,4294,3296,998,0.767582673497904,0.232417326502096
"08005007201",8005007201,3589,1882,1707,0.524380050153246,0.475619949846754
"08005007202",8005007202,3915,1972,1943,0.503703703703704,0.496296296296296
"08005007302",8005007302,4927,2449,2478,0.497057032677085,0.502942967322915
"08005007400",8005007400,4992,2979,2013,0.596754807692308,0.403245192307692
"08005007600",8005007600,3256,1741,1515,0.53470515970516,0.46529484029484
"08005007702",8005007702,4168,2167,2001,0.519913627639155,0.480086372360845
"08005007703",8005007703,4075,1953,2122,0.479263803680982,0.520736196319018
"08005007704",8005007704,4797,1944,2853,0.405253283302064,0.594746716697936
"08005015100",8005015100,2521,2288,233,0.907576358587862,0.092423641412138
"08005080000",8005080000,3437,1911,1526,0.556008146639511,0.443991853360489
"08005080200",8005080200,5086,3166,1920,0.622493118364137,0.377506881635863
"08005080400",8005080400,4500,3388,1112,0.752888888888889,0.247111111111111
"08005080600",8005080600,3730,2239,1491,0.600268096514745,0.399731903485255
"08005080700",8005080700,5545,3181,2364,0.573669972948602,0.426330027051398
"08005080800",8005080800,2661,1434,1227,0.538895152198422,0.461104847801578
"08005080900",8005080900,3977,2396,1581,0.602464168971587,0.397535831028413
"08005081000",8005081000,5450,2543,2907,0.466605504587156,0.533394495412844
"08005081100",8005081100,5376,2228,3148,0.414434523809524,0.585565476190476
"08005081200",8005081200,4462,2050,2412,0.459435230838189,0.540564769161811
"08005081300",8005081300,3119,1532,1587,0.491183071497275,0.508816928502725
"08005081500",8005081500,3039,2887,152,0.94998354721948,0.0500164527805199
"08005081700",8005081700,2782,2151,631,0.773184759166068,0.226815240833932
"08005081800",8005081800,5421,2599,2822,0.479431839144069,0.520568160855931
"08005081900",8005081900,6332,2948,3384,0.465571699305117,0.534428300694883
"08005082000",8005082000,3797,1718,2079,0.452462470371346,0.547537529628654
"08005082100",8005082100,6750,3412,3338,0.505481481481482,0.494518518518518
"08005082200",8005082200,5627,3292,2335,0.585036431491025,0.414963568508975
"08005082300",8005082300,3636,2179,1457,0.599284928492849,0.400715071507151
"08005082400",8005082400,4265,2839,1426,0.665650644783118,0.334349355216882
"08005082500",8005082500,2310,1663,647,0.71991341991342,0.28008658008658
"08005082600",8005082600,5059,2483,2576,0.490808460169994,0.509191539830006
"08005082800",8005082800,5030,3214,1816,0.6389662027833,0.3610337972167
"08005082900",8005082900,4522,3000,1522,0.663423264042459,0.336576735957541
"08005083000",8005083000,3245,2156,1089,0.664406779661017,0.335593220338983
"08005083100",8005083100,6739,3819,2920,0.566701290992729,0.433298709007271
"08005083200",8005083200,8692,6172,2520,0.7100782328578,0.2899217671422
"08005083300",8005083300,4399,3063,1336,0.696294612411912,0.303705387588088
"08005083400",8005083400,6685,4775,1910,0.714285714285714,0.285714285714286
"08005083500",8005083500,5274,2856,2418,0.541524459613197,0.458475540386803
"08005083600",8005083600,3661,2558,1103,0.698716197760175,0.301283802239825
"08005083700",8005083700,4356,3379,977,0.775711662075298,0.224288337924702
"08005083800",8005083800,2842,1989,853,0.699859254046446,0.300140745953554
"08005083900",8005083900,2853,2081,772,0.729407641079565,0.270592358920435
"08005084100",8005084100,4435,3055,1380,0.688838782412627,0.311161217587373
"08005084200",8005084200,3548,2553,995,0.7195603156708,0.2804396843292
"08005084300",8005084300,3456,2569,887,0.743344907407407,0.256655092592593
"08005084400",8005084400,3143,2117,1026,0.673560292713968,0.326439707286032
"08005084800",8005084800,3444,2704,740,0.78513356562137,0.21486643437863
"08005084900",8005084900,3066,2489,577,0.811806914546641,0.188193085453359
"08005085000",8005085000,1805,1104,701,0.611634349030471,0.388365650969529
"08005085100",8005085100,6698,4802,1896,0.716930426993132,0.283069573006868
"08005085200",8005085200,2809,2419,390,0.861160555357779,0.138839444642221
"08005085300",8005085300,2284,1730,554,0.757443082311734,0.242556917688266
"08005085400",8005085400,4320,3304,1016,0.764814814814815,0.235185185185185
"08005085500",8005085500,5316,4310,1006,0.810759969902182,0.189240030097818
"08005085600",8005085600,3203,2575,628,0.803933812051202,0.196066187948798
"08005085800",8005085800,1706,1361,345,0.797772567409144,0.202227432590856
"08005086100",8005086100,4784,3686,1098,0.770484949832776,0.229515050167224
"08005086300",8005086300,3696,2793,903,0.755681818181818,0.244318181818182
"08005086700",8005086700,3611,3029,582,0.838825810024924,0.161174189975076
"08005086800",8005086800,6106,3404,2702,0.557484441532918,0.442515558467082
"08005086900",8005086900,2823,1558,1265,0.55189514700673,0.44810485299327
"08005087000",8005087000,4550,2289,2261,0.503076923076923,0.496923076923077
"08005087200",8005087200,3768,2469,1299,0.655254777070064,0.344745222929936
"08005087300",8005087300,7087,3807,3280,0.53718075349231,0.46281924650769
"08013012101",8013012101,4770,4517,253,0.946960167714885,0.0530398322851153
"08013012104",8013012104,2538,2341,197,0.922379826635146,0.0776201733648542
"08013012201",8013012201,3388,3239,149,0.956021251475797,0.043978748524203
"08013012202",8013012202,5847,5202,645,0.889687018984094,0.110312981015906
"08013012204",8013012204,3556,3319,237,0.933352080989876,0.0666479190101237
"08013012300",8013012300,6196,4863,1333,0.784861200774693,0.215138799225307
"08013012401",8013012401,5699,5335,364,0.936129145464117,0.0638708545358835
"08013012501",8013012501,2451,2149,302,0.876784985720114,0.123215014279886
"08013012507",8013012507,4202,3696,506,0.879581151832461,0.120418848167539
"08013012508",8013012508,2833,2520,313,0.889516413695729,0.110483586304271
"08013012510",8013012510,4316,4035,281,0.934893419833179,0.0651065801668211
"08013012511",8013012511,6265,5358,907,0.855227454110136,0.144772545889864
"08013012605",8013012605,1529,1191,338,0.778940483976455,0.221059516023545
"08013012608",8013012608,2239,2037,202,0.909781152300134,0.090218847699866
"08013012705",8013012705,3507,3041,466,0.867122897063017,0.132877102936983
"08013012707",8013012707,2194,1822,372,0.830446672743847,0.169553327256153
"08013012708",8013012708,5123,4757,366,0.928557485848136,0.0714425141518641
"08013012709",8013012709,1811,1715,96,0.946990612921038,0.0530093870789619
"08013012710",8013012710,3685,3373,312,0.915332428765265,0.0846675712347355
"08013012903",8013012903,2195,2000,195,0.911161731207289,0.0888382687927107
"08013012904",8013012904,5156,4551,605,0.88266097750194,0.11733902249806
"08013012905",8013012905,2481,2125,356,0.856509471987102,0.143490528012898
"08013012907",8013012907,2922,2633,289,0.901095140314853,0.0989048596851472
"08013013003",8013013003,5452,5021,431,0.920946441672781,0.0790535583272194
"08013013004",8013013004,3414,3057,357,0.895430579964851,0.104569420035149
"08013013006",8013013006,5304,4856,448,0.91553544494721,0.0844645550527904
"08013013201",8013013201,1531,1420,111,0.92749836708034,0.0725016329196604
"08013013205",8013013205,5078,4762,316,0.937770775896022,0.0622292241039779
"08013013207",8013013207,4276,3875,401,0.90622076707203,0.0937792329279701
"08013013210",8013013210,5032,3876,1156,0.77027027027027,0.22972972972973
"08013013211",8013013211,5612,4808,804,0.856735566642908,0.143264433357092
"08013013305",8013013305,4859,4047,812,0.832887425396172,0.167112574603828
"08013013306",8013013306,4589,3818,771,0.831989540204838,0.168010459795162
"08013013308",8013013308,3465,3083,382,0.88975468975469,0.11024531024531
"08013013402",8013013402,7573,6016,1557,0.794401162022976,0.205598837977024
"08013013503",8013013503,5478,4235,1243,0.773092369477912,0.226907630522088
"08013013505",8013013505,3831,2993,838,0.781258157139128,0.218741842860872
"08013013506",8013013506,4058,3490,568,0.860029571217348,0.139970428782652
"08013013507",8013013507,3397,2775,622,0.816897262290256,0.183102737709744
"08013013601",8013013601,3831,3605,226,0.941007569825111,0.0589924301748891
"08013013602",8013013602,912,884,28,0.969298245614035,0.0307017543859649
"08013013701",8013013701,6334,6002,332,0.94758446479318,0.0524155352068203
"08013060600",8013060600,5325,4335,990,0.814084507042254,0.185915492957746
"08013060700",8013060700,3091,2755,336,0.891297314784859,0.108702685215141
"08013060800",8013060800,6107,4717,1390,0.772392336662846,0.227607663337154
"08013060900",8013060900,4139,3568,571,0.862043971973907,0.137956028026093
"08013061300",8013061300,3417,2881,536,0.843137254901961,0.156862745098039
"08014030000",8014030000,3378,2735,643,0.809650680876258,0.190349319123742
"08014030100",8014030100,2183,1961,222,0.898305084745763,0.101694915254237
"08014030200",8014030200,1672,1472,200,0.880382775119617,0.119617224880383
"08014030400",8014030400,3789,3462,327,0.913697545526524,0.0863024544734758
"08014030600",8014030600,6166,5004,1162,0.811547194291275,0.188452805708725
"08014030800",8014030800,5420,4623,797,0.852952029520295,0.147047970479705
"08014030900",8014030900,5938,5337,601,0.898787470528798,0.101212529471202
"08014031100",8014031100,2606,2104,502,0.807367613200307,0.192632386799693
"08014031200",8014031200,3059,2578,481,0.842759071592024,0.157240928407976
"08014031300",8014031300,1648,1506,142,0.913834951456311,0.0861650485436893
"08014031400",8014031400,2583,2384,199,0.922957801006582,0.0770421989934185
"08019014700",8019014700,4959,4756,203,0.95906432748538,0.0409356725146199
"08019014800",8019014800,1610,1537,73,0.954658385093168,0.0453416149068323
"08031000102",8031000102,3109,2547,562,0.819234480540367,0.180765519459633
"08031000202",8031000202,3916,2525,1391,0.644790602655771,0.355209397344229
"08031000301",8031000301,5003,4212,791,0.841894863082151,0.158105136917849
"08031000401",8031000401,3209,2341,868,0.729510751012777,0.270489248987223
"08031000501",8031000501,1814,1598,216,0.880926130099228,0.119073869900772
"08031000600",8031000600,2552,1754,798,0.68730407523511,0.31269592476489
"08031000701",8031000701,4166,2762,1404,0.662986077772444,0.337013922227556
"08031000905",8031000905,3631,2243,1388,0.617736160837235,0.382263839162765
"08031001000",8031001000,3941,2106,1835,0.534382136513575,0.465617863486425
"08031001101",8031001101,2601,1581,1020,0.607843137254902,0.392156862745098
"08031001301",8031001301,4972,2976,1996,0.598551890587289,0.401448109412711
"08031001401",8031001401,5750,3441,2309,0.598434782608696,0.401565217391304
"08031001402",8031001402,4070,2356,1714,0.578869778869779,0.421130221130221
"08031001701",8031001701,4350,3739,611,0.859540229885058,0.140459770114942
"08031001702",8031001702,3648,2976,672,0.815789473684211,0.184210526315789
"08031001902",8031001902,705,598,107,0.84822695035461,0.15177304964539
"08031002000",8031002000,1577,1303,274,0.826252377932784,0.173747622067216
"08031002100",8031002100,4879,3854,1025,0.789915966386555,0.210084033613445
"08031002300",8031002300,4831,2532,2299,0.524115090043469,0.475884909956531
"08031002403",8031002403,3338,1959,1379,0.586878370281606,0.413121629718394
"08031002601",8031002601,3087,2468,619,0.799481697440881,0.200518302559119
"08031002602",8031002602,2736,2238,498,0.817982456140351,0.182017543859649
"08031002701",8031002701,4600,3828,772,0.832173913043478,0.167826086956522
"08031002801",8031002801,2583,2343,240,0.907084785133566,0.0929152148664344
"08031002802",8031002802,4213,3602,611,0.854972703536672,0.145027296463328
"08031002803",8031002803,4158,3774,384,0.907647907647908,0.0923520923520924
"08031002901",8031002901,2602,2339,263,0.898923904688701,0.101076095311299
"08031003001",8031003001,5393,4996,397,0.926386055998517,0.0736139440014834
"08031003003",8031003003,3138,2723,415,0.867750159337157,0.132249840662843
"08031003004",8031003004,6237,5481,756,0.878787878787879,0.121212121212121
"08031003102",8031003102,3389,2416,973,0.712894659191502,0.287105340808498
"08031003201",8031003201,4970,4344,626,0.874044265593561,0.125955734406439
"08031003202",8031003202,3001,2636,365,0.878373875374875,0.121626124625125
"08031003203",8031003203,3001,2816,185,0.93835388203932,0.0616461179606798
"08031003300",8031003300,3099,2858,241,0.922232978380123,0.0777670216198774
"08031003401",8031003401,2420,2305,115,0.952479338842975,0.0475206611570248
"08031003402",8031003402,4485,4251,234,0.947826086956522,0.0521739130434783
"08031003601",8031003601,4651,2250,2401,0.483766931842614,0.516233068157385
"08031003701",8031003701,2907,2357,550,0.810801513587891,0.189198486412109
"08031003703",8031003703,2779,2323,456,0.835912198632602,0.164087801367398
"08031003800",8031003800,5589,5099,490,0.912327786723922,0.087672213276078
"08031003901",8031003901,4172,3900,272,0.934803451581975,0.0651965484180249
"08031003902",8031003902,3892,3595,297,0.923689619732785,0.0763103802672148
"08031004005",8031004005,3002,2542,460,0.846768820786143,0.153231179213857
"08031004006",8031004006,4489,4009,480,0.893071953664513,0.106928046335487
"08031004101",8031004101,3648,1053,2595,0.288651315789474,0.711348684210526
"08031004106",8031004106,10138,8319,1819,0.820576050503058,0.179423949496942
"08031004107",8031004107,3810,2902,908,0.761679790026247,0.238320209973753
"08031004201",8031004201,4481,3873,608,0.864316000892658,0.135683999107342
"08031004202",8031004202,4109,3208,901,0.780725237284011,0.219274762715989
"08031004301",8031004301,4469,3400,1069,0.760796598791676,0.239203401208324
"08031004302",8031004302,2467,2150,317,0.871503850830969,0.128496149169031
"08031004303",8031004303,4067,3823,244,0.940004917629703,0.0599950823702975
"08031004304",8031004304,5456,4538,918,0.831744868035191,0.168255131964809
"08031004306",8031004306,4807,4007,800,0.833576034949033,0.166423965050967
"08031004404",8031004404,5978,2156,3822,0.360655737704918,0.639344262295082
"08031004405",8031004405,7316,5721,1595,0.781984691088026,0.218015308911974
"08031004503",8031004503,3974,2152,1822,0.541519879214897,0.458480120785103
"08031004504",8031004504,3705,1801,1904,0.486099865047233,0.513900134952767
"08031004505",8031004505,4357,2113,2244,0.484966720220335,0.515033279779665
"08031004601",8031004601,5415,3630,1785,0.670360110803324,0.329639889196676
"08031004602",8031004602,7037,4066,2971,0.577803041068637,0.422196958931363
"08031004603",8031004603,5327,3595,1732,0.674863900882298,0.325136099117702
"08031004700",8031004700,6198,4041,2157,0.651984511132623,0.348015488867377
"08031006701",8031006701,2018,1696,322,0.840436075322101,0.159563924677899
"08031005001",8031005001,2586,1770,816,0.68445475638051,0.31554524361949
"08031005102",8031005102,3368,2779,589,0.825118764845606,0.174881235154394
"08031005104",8031005104,3111,2223,888,0.714561234329797,0.285438765670203
"08031005200",8031005200,3052,2634,418,0.863040629095675,0.136959370904325
"08031005300",8031005300,1206,1049,157,0.869817578772803,0.130182421227197
"08031005502",8031005502,1856,1349,507,0.726831896551724,0.273168103448276
"08031005503",8031005503,4644,3649,995,0.785745047372954,0.214254952627046
"08031006804",8031006804,2184,1949,235,0.892399267399267,0.107600732600733
"08031006809",8031006809,6979,5647,1332,0.809141710846826,0.190858289153174
"08031006810",8031006810,5207,3710,1497,0.712502400614557,0.287497599385443
"08031006811",8031006811,5865,4566,1299,0.778516624040921,0.221483375959079
"08031006812",8031006812,3108,2752,356,0.885456885456886,0.114543114543114
"08031006813",8031006813,3871,2563,1308,0.662102815809868,0.337897184190132
"08031006814",8031006814,4703,3214,1489,0.683393578566872,0.316606421433128
"08031006901",8031006901,5808,3634,2174,0.62568870523416,0.37431129476584
"08031007006",8031007006,4464,2225,2239,0.498431899641577,0.501568100358423
"08031007013",8031007013,3096,2431,665,0.785206718346253,0.214793281653747
"08031007088",8031007088,4168,2955,1213,0.708973128598848,0.291026871401152
"08031007089",8031007089,4725,3644,1081,0.771216931216931,0.228783068783069
"08031008304",8031008304,3637,1254,2383,0.344789661809183,0.655210338190817
"08031008305",8031008305,3963,1957,2006,0.493817814786778,0.506182185213222
"08031008306",8031008306,5451,1872,3579,0.343423225096313,0.656576774903687
"08031008312",8031008312,6825,2173,4652,0.318388278388278,0.681611721611722
"08031008386",8031008386,4511,1879,2632,0.416537353136777,0.583462646863223
"08031008387",8031008387,5961,2547,3414,0.427277302466029,0.572722697533971
"08031008389",8031008389,7516,3217,4299,0.428020223523151,0.571979776476849
"08031008390",8031008390,7703,2950,4753,0.382967674931845,0.617032325068155
"08031008391",8031008391,7020,2804,4216,0.399430199430199,0.600569800569801
"08031011902",8031011902,6695,4909,1786,0.733233756534727,0.266766243465273
"08031011903",8031011903,2194,1683,511,0.767092069279854,0.232907930720146
"08031012001",8031012001,2032,1726,306,0.849409448818898,0.150590551181102
"08031015300",8031015300,3832,2902,930,0.757306889352818,0.242693110647182
"08031015500",8031015500,3313,2146,1167,0.647751282825234,0.352248717174766
"08031015600",8031015600,6498,3240,3258,0.498614958448753,0.501385041551247
"08031015700",8031015700,5535,3837,1698,0.693224932249322,0.306775067750678
"08031980000",8031980000,1165,638,527,0.547639484978541,0.452360515021459
"08035013904",8035013904,3742,3354,388,0.896312132549439,0.103687867450561
"08035013905",8035013905,3733,3378,355,0.904902223412805,0.0950977765871953
"08035013907",8035013907,4596,4206,390,0.915143603133159,0.0848563968668408
"08035013908",8035013908,6306,5916,390,0.938154138915319,0.0618458610846813
"08035013909",8035013909,6169,5759,410,0.933538661047171,0.0664613389528287
"08035013910",8035013910,6263,5865,398,0.936452179466709,0.0635478205332908
"08035013911",8035013911,6586,6047,539,0.918159732766474,0.0818402672335257
"08035014001",8035014001,6242,5526,716,0.885293175264338,0.114706824735662
"08035014005",8035014005,4382,3991,391,0.910771337288909,0.0892286627110909
"08035014007",8035014007,2410,1964,446,0.8149377593361,0.1850622406639
"08035014008",8035014008,6637,6127,510,0.923158053337351,0.0768419466626488
"08035014009",8035014009,3587,3204,383,0.893225536660162,0.106774463339838
"08035014010",8035014010,5466,4704,762,0.860592755214051,0.139407244785949
"08035014011",8035014011,1692,1379,313,0.815011820330969,0.184988179669031
"08035014012",8035014012,7440,6735,705,0.905241935483871,0.094758064516129
"08035014107",8035014107,3718,3380,338,0.909090909090909,0.0909090909090909
"08035014108",8035014108,4894,4559,335,0.931548835308541,0.068451164691459
"08035014110",8035014110,5406,4654,752,0.860895301516833,0.139104698483167
"08035014112",8035014112,3834,3469,365,0.904799165362546,0.0952008346374543
"08035014113",8035014113,2930,2578,352,0.879863481228669,0.120136518771331
"08035014114",8035014114,3517,3055,462,0.868638043787319,0.131361956212681
"08035014115",8035014115,4249,3750,499,0.882560602494705,0.117439397505295
"08035014116",8035014116,4440,3703,737,0.834009009009009,0.165990990990991
"08035014122",8035014122,6572,6114,458,0.930310407790627,0.0696895922093731
"08035014124",8035014124,5456,4901,555,0.898277126099707,0.101722873900293
"08035014125",8035014125,2579,2376,203,0.921287320666925,0.0787126793330748
"08035014126",8035014126,1283,1131,152,0.881527669524552,0.118472330475448
"08035014127",8035014127,5220,4785,435,0.916666666666667,0.0833333333333334
"08035014128",8035014128,4611,4193,418,0.90934721318586,0.0906527868141401
"08035014129",8035014129,3740,3402,338,0.909625668449198,0.0903743315508021
"08035014130",8035014130,7591,6804,787,0.896324594915031,0.103675405084969
"08035014131",8035014131,3283,3000,283,0.913798355162961,0.0862016448370393
"08035014133",8035014133,6346,5738,608,0.904191616766467,0.0958083832335329
"08035014134",8035014134,5897,5155,742,0.87417330846193,0.12582669153807
"08035014135",8035014135,2412,2237,175,0.927446102819237,0.0725538971807629
"08035014136",8035014136,8411,7225,1186,0.858994174295565,0.141005825704435
"08035014137",8035014137,9410,7894,1516,0.838894792773645,0.161105207226355
"08035014138",8035014138,2902,2484,418,0.855961405926947,0.144038594073053
"08035014202",8035014202,1845,1788,57,0.969105691056911,0.0308943089430894
"08035014203",8035014203,6272,5870,402,0.935905612244898,0.064094387755102
"08035014204",8035014204,3188,2937,251,0.921267252195734,0.078732747804266
"08035014300",8035014300,730,704,26,0.964383561643836,0.0356164383561643
"08035014403",8035014403,5076,4724,352,0.930654058313633,0.0693459416863672
"08035014404",8035014404,2323,2199,124,0.946620749031425,0.0533792509685751
"08035014405",8035014405,7765,7232,533,0.931358660656793,0.0686413393432067
"08035014406",8035014406,7382,6757,625,0.915334597670008,0.0846654023299919
"08035014503",8035014503,5592,5027,565,0.898962804005722,0.101037195994278
"08035014505",8035014505,4101,3714,387,0.905632772494514,0.0943672275054864
"08035014506",8035014506,3435,3205,230,0.933042212518195,0.0669577874818049
"08035014603",8035014603,6739,6257,482,0.928476035020033,0.0715239649799674
"08035014604",8035014604,4022,3696,326,0.918945798110393,0.0810542018896072
"08039961204",8039961204,6687,6258,429,0.935845670704352,0.0641543292956482
"08039961206",8039961206,3412,3246,166,0.951348182883939,0.0486518171160609
"08039961207",8039961207,3711,3516,195,0.947453516572352,0.0525464834276476
"08039961209",8039961209,2351,2226,125,0.946831135686942,0.0531688643130582
"08059009807",8059009807,1611,1521,90,0.94413407821229,0.0558659217877095
"08059009815",8059009815,4956,4633,323,0.934826472962066,0.0651735270379338
"08059009824",8059009824,5028,4454,574,0.885839299920446,0.114160700079554
"08059009827",8059009827,6180,5238,942,0.847572815533981,0.152427184466019
"08059009828",8059009828,5344,4861,483,0.909618263473054,0.0903817365269461
"08059009829",8059009829,1857,1699,158,0.914916532040926,0.0850834679590737
"08059009830",8059009830,2046,1841,205,0.89980449657869,0.10019550342131
"08059009833",8059009833,5555,4818,737,0.867326732673267,0.132673267326733
"08059009834",8059009834,4307,3903,404,0.906199210587416,0.0938007894125842
"08059009835",8059009835,3575,3356,219,0.938741258741259,0.0612587412587413
"08059009836",8059009836,3796,3565,231,0.939146469968388,0.0608535300316122
"08059009837",8059009837,2750,2641,109,0.960363636363636,0.0396363636363637
"08059009838",8059009838,4360,4151,209,0.952064220183486,0.0479357798165138
"08059009839",8059009839,2484,2331,153,0.938405797101449,0.0615942028985508
"08059009840",8059009840,3685,3507,178,0.951696065128901,0.0483039348710991
"08059009841",8059009841,2201,2087,114,0.948205361199455,0.0517946388005452
"08059009842",8059009842,2942,2697,245,0.916723317471108,0.0832766825288919
"08059009843",8059009843,7375,6995,380,0.948474576271186,0.0515254237288135
"08059009845",8059009845,4010,3836,174,0.956608478802992,0.0433915211970075
"08059009846",8059009846,4786,4624,162,0.966151274550773,0.0338487254492269
"08059009848",8059009848,2519,2430,89,0.964668519253672,0.0353314807463279
"08059009852",8059009852,3528,3369,159,0.954931972789116,0.0450680272108843
"08059009900",8059009900,2451,2272,179,0.926968584251326,0.073031415748674
"08059010000",8059010000,4535,3968,567,0.87497243660419,0.12502756339581
"08059010100",8059010100,4360,3894,466,0.893119266055046,0.106880733944954
"08059010205",8059010205,2326,2225,101,0.956577815993121,0.0434221840068788
"08059010208",8059010208,5707,4934,773,0.864552304187839,0.135447695812161
"08059010209",8059010209,6152,5247,905,0.852893368010403,0.147106631989597
"08059010210",8059010210,3460,3175,285,0.917630057803468,0.0823699421965318
"08059010211",8059010211,3093,2731,362,0.882961526026511,0.117038473973489
"08059010212",8059010212,4481,3888,593,0.867663467975898,0.132336532024102
"08059010213",8059010213,4786,4057,729,0.847680735478479,0.152319264521521
"08059010303",8059010303,5333,4919,414,0.922370148134258,0.0776298518657416
"08059010304",8059010304,2819,2620,199,0.929407591344448,0.0705924086555516
"08059010305",8059010305,3641,3159,482,0.867618786047789,0.132381213952211
"08059010306",8059010306,2750,2508,242,0.912,0.088
"08059010307",8059010307,4579,4112,467,0.898012666521074,0.101987333478926
"08059010308",8059010308,5426,4921,505,0.906929598230741,0.0930704017692591
"08059010402",8059010402,5080,4362,718,0.858661417322835,0.141338582677165
"08059010403",8059010403,5279,4269,1010,0.808675885584391,0.191324114415609
"08059010406",8059010406,2428,1969,459,0.810955518945634,0.189044481054366
"08059010502",8059010502,5100,4490,610,0.880392156862745,0.119607843137255
"08059010503",8059010503,4462,4021,441,0.901165396683102,0.0988346033168983
"08059010603",8059010603,3137,2594,543,0.826904686005738,0.173095313994262
"08059010604",8059010604,2310,1959,351,0.848051948051948,0.151948051948052
"08059010702",8059010702,5060,3747,1313,0.740513833992095,0.259486166007905
"08059010801",8059010801,2497,2343,154,0.938325991189427,0.0616740088105727
"08059010901",8059010901,4793,4226,567,0.881702482787398,0.118297517212602
"08059011000",8059011000,5500,4722,778,0.858545454545455,0.141454545454545
"08059011100",8059011100,6135,4792,1343,0.781092094539527,0.218907905460473
"08059011300",8059011300,3115,2628,487,0.843659711075441,0.156340288924559
"08059011401",8059011401,2822,1902,920,0.673990077958894,0.326009922041106
"08059011402",8059011402,3839,2854,985,0.743422766345402,0.256577233654598
"08059011550",8059011550,6198,4399,1799,0.709745079057761,0.290254920942239
"08059011601",8059011601,4021,2726,1295,0.677940810743596,0.322059189256404
"08059011602",8059011602,4006,2810,1196,0.701447828257614,0.298552171742386
"08059011701",8059011701,4376,3753,623,0.857632541133455,0.142367458866545
"08059011702",8059011702,5382,4516,866,0.839093273875883,0.160906726124117
"08059011710",8059011710,3937,3528,409,0.896113792227584,0.103886207772416
"08059011711",8059011711,4017,3558,459,0.885735623599701,0.114264376400299
"08059011712",8059011712,4061,3799,262,0.935483870967742,0.0645161290322581
"08059011721",8059011721,2686,2468,218,0.918838421444527,0.0811615785554728
"08059011724",8059011724,4340,3979,361,0.916820276497696,0.0831797235023042
"08059011725",8059011725,1776,1662,114,0.935810810810811,0.0641891891891891
"08059011726",8059011726,5754,5175,579,0.899374348279458,0.100625651720542
"08059011727",8059011727,3641,3306,335,0.907992309804999,0.0920076901950013
"08059011729",8059011729,3871,3251,620,0.839834668044433,0.160165331955567
"08059011730",8059011730,3618,3068,550,0.847982310668878,0.152017689331122
"08059011731",8059011731,4227,3625,602,0.857582209604921,0.142417790395079
"08059011733",8059011733,1530,1312,218,0.857516339869281,0.142483660130719
"08059011803",8059011803,5276,3617,1659,0.685557240333586,0.314442759666414
"08059011805",8059011805,4628,3491,1137,0.754321521175454,0.245678478824546
"08059011806",8059011806,4829,3641,1188,0.753986332574032,0.246013667425968
"08059011951",8059011951,3103,2437,666,0.785368997744119,0.214631002255881
"08059012022",8059012022,5518,5186,332,0.939833272924973,0.0601667270750272
"08059012023",8059012023,3386,3062,324,0.90431187241583,0.0956881275841701
"08059012024",8059012024,4988,4727,261,0.947674418604651,0.0523255813953488
"08059012027",8059012027,2952,2854,98,0.96680216802168,0.0331978319783198
"08059012030",8059012030,3719,3583,136,0.963431029846733,0.036568970153267
"08059012031",8059012031,3739,3631,108,0.971115271462958,0.0288847285370419
"08059012032",8059012032,2574,2492,82,0.968142968142968,0.0318570318570318
"08059012033",8059012033,2860,2759,101,0.964685314685315,0.0353146853146853
"08059012034",8059012034,3459,3347,112,0.967620699624169,0.0323793003758311
"08059012035",8059012035,5294,5058,236,0.955421231582924,0.044578768417076
"08059012037",8059012037,3331,3209,122,0.963374362053437,0.0366256379465626
"08059012038",8059012038,3160,2894,266,0.915822784810127,0.0841772151898734
"08059012039",8059012039,5312,4785,527,0.900790662650602,0.0992093373493976
"08059012041",8059012041,5253,4578,675,0.871501998857796,0.128498001142204
"08059012042",8059012042,3851,3463,388,0.899246948844456,0.100753051155544
"08059012043",8059012043,5124,4726,398,0.922326307572209,0.0776736924277908
"08059012044",8059012044,3730,3375,355,0.904825737265416,0.0951742627345844
"08059012046",8059012046,2207,1953,254,0.884911644766652,0.115088355233348
"08059012047",8059012047,4053,3551,502,0.87614113002714,0.12385886997286
"08059012048",8059012048,2418,2271,147,0.939205955334988,0.0607940446650124
"08059012050",8059012050,3942,3309,633,0.839421613394216,0.160578386605784
"08059012051",8059012051,3425,3227,198,0.942189781021898,0.0578102189781022
"08059012052",8059012052,5326,4858,468,0.912129177619226,0.0878708223807736
"08059012053",8059012053,3794,3555,239,0.937005798629415,0.0629942013705851
"08059012055",8059012055,3706,3399,307,0.917161359956827,0.0828386400431732
"08059012058",8059012058,3660,3557,103,0.971857923497268,0.0281420765027323
"08059012060",8059012060,3336,3076,260,0.922062350119904,0.0779376498800959
"08059015800",8059015800,3523,3103,420,0.880783423218848,0.119216576781152
"08059060300",8059060300,4687,3868,819,0.825261361211863,0.174738638788137
"08059060400",8059060400,3482,2911,571,0.836013785180931,0.163986214819069
"08059060500",8059060500,4040,3618,422,0.895544554455446,0.104455445544554
"08059980400",8059980400,1128,634,494,0.562056737588652,0.437943262411348
"08093000100",8093000100,5587,5278,309,0.944693037408269,0.0553069625917308
"08093000200",8093000200,3647,3450,197,0.945982999725802,0.054017000274198
"08123001800",8123001800,4222,3335,887,0.789909995262909,0.210090004737091
"08123001902",8123001902,7743,5947,1796,0.768048559989668,0.231951440010332
"08123001905",8123001905,4322,3078,1244,0.712170291531698,0.287829708468302
"08123001906",8123001906,1502,1216,286,0.809587217043941,0.190412782956059
"08123001908",8123001908,3000,2014,986,0.671333333333333,0.328666666666667
"08123002004",8123002004,3729,2850,879,0.764279967819791,0.235720032180209
"08123002005",8123002005,561,463,98,0.825311942959002,0.174688057040998
"08123002006",8123002006,339,285,54,0.84070796460177,0.15929203539823
"08123002007",8123002007,5110,4439,671,0.868688845401174,0.131311154598826
"08123002008",8123002008,4621,4140,481,0.895909976195629,0.104090023804371
"08123002009",8123002009,1332,1241,91,0.931681681681682,0.0683183183183184
"08123002010",8123002010,1964,1521,443,0.774439918533605,0.225560081466395
"08123002011",8123002011,334,301,33,0.901197604790419,0.0988023952095808
"08123002013",8123002013,2760,2458,302,0.890579710144928,0.109420289855072
"08123002014",8123002014,1455,1273,182,0.874914089347079,0.125085910652921
"08123002015",8123002015,1148,1032,116,0.898954703832753,0.101045296167247
"08123002016",8123002016,3023,2451,572,0.810783989414489,0.189216010585511
"08123002018",8123002018,893,808,85,0.90481522956327,0.0951847704367301
"08123002019",8123002019,3413,3027,386,0.886903017872839,0.113096982127161
"08123002020",8123002020,4990,4467,523,0.895190380761523,0.104809619238477
"08123002103",8123002103,8009,7269,740,0.907603945561244,0.0923960544387564
"08001007801",8001007801,3732,1452,2280,0.389067524115756,0.610932475884244
"08001007900",8001007900,5555,2398,3157,0.431683168316832,0.568316831683168
"08001008308",8001008308,5557,2870,2687,0.516465718913083,0.483534281086917
"08001008353",8001008353,6044,3559,2485,0.588848444738584,0.411151555261416
"08001008401",8001008401,4315,3864,451,0.895480880648899,0.104519119351101
"08001008508",8001008508,5342,4315,1027,0.807749906402097,0.192250093597903
"08001008535",8001008535,3298,2486,812,0.75379017586416,0.24620982413584
"08001008538",8001008538,5305,4349,956,0.819792648444863,0.180207351555137
"08001008547",8001008547,3525,2915,610,0.826950354609929,0.173049645390071
"08001008901",8001008901,2316,1411,905,0.609240069084629,0.390759930915371
"08001009002",8001009002,9203,6515,2688,0.707921330001087,0.292078669998913
"08001009326",8001009326,2554,2140,414,0.837901331245106,0.162098668754894
"08001009409",8001009409,5248,4582,666,0.873094512195122,0.126905487804878
"08001009606",8001009606,2794,1827,967,0.653901216893343,0.346098783106657
"08001009608",8001009608,2849,2126,723,0.746226746226746,0.253773253773254
"08005005620",8005005620,2539,2253,286,0.887357227254825,0.112642772745175
"08005005621",8005005621,2899,2744,155,0.946533287340462,0.0534667126595377
"08005005622",8005005622,2326,2169,157,0.93250214961307,0.0674978503869303
"08005005629",8005005629,2215,2113,102,0.953950338600451,0.0460496613995486
"08005005635",8005005635,4789,4476,313,0.934641887659219,0.0653581123407809
"08005005636",8005005636,1825,1732,93,0.949041095890411,0.050958904109589
"08005006708",8005006708,4979,4540,439,0.911829684675638,0.0881703153243624
"08005006854",8005006854,2383,1880,503,0.788921527486362,0.211078472513638
"08005006857",8005006857,2158,1931,227,0.894810009267841,0.105189990732159
"08005007107",8005007107,4430,3497,933,0.789390519187359,0.210609480812641
"08005007301",8005007301,2548,1163,1385,0.456436420722135,0.543563579277865
"08005007500",8005007500,2458,1501,957,0.610659072416599,0.389340927583401
"08005080100",8005080100,4277,2190,2087,0.512041150339023,0.487958849660977
"08005080300",8005080300,5701,3795,1906,0.665672689001929,0.334327310998071
"08005080500",8005080500,3059,2266,793,0.740764955867931,0.259235044132069
"08005081400",8005081400,4171,2904,1267,0.696235914648765,0.303764085351235
"08005081600",8005081600,4859,3635,1224,0.748096316114427,0.251903683885573
"08005082700",8005082700,3499,2089,1410,0.597027722206345,0.402972277793655
"08005084000",8005084000,2327,1768,559,0.759776536312849,0.240223463687151
"08005084500",8005084500,2708,1831,877,0.676144756277696,0.323855243722304
"08005084600",8005084600,5196,3801,1395,0.731524249422633,0.268475750577367
"08005084700",8005084700,4665,3540,1125,0.758842443729904,0.241157556270096
"08005085700",8005085700,4611,3434,1177,0.744740837128606,0.255259162871394
"08005085900",8005085900,3248,2106,1142,0.648399014778325,0.351600985221675
"08005086000",8005086000,7684,5593,2091,0.72787610619469,0.27212389380531
"08005086200",8005086200,5814,4498,1316,0.773649810801514,0.226350189198486
"08005086400",8005086400,1980,1752,228,0.884848484848485,0.115151515151515
"08005086500",8005086500,4632,3673,959,0.792962003454231,0.207037996545769
"08005086600",8005086600,4075,3574,501,0.877055214723926,0.122944785276074
"08005087100",8005087100,2505,1541,964,0.615169660678643,0.384830339321357
"08013012102",8013012102,6466,5802,664,0.897309000927931,0.102690999072069
"08013012103",8013012103,3804,3424,380,0.900105152471083,0.099894847528917
"08013012105",8013012105,5589,4513,1076,0.807478976561102,0.192521023438898
"08013012203",8013012203,6081,4640,1441,0.763032395987502,0.236967604012498
"08013012505",8013012505,4102,3793,309,0.924670892247684,0.0753291077523159
"08013012509",8013012509,3247,2978,269,0.917154296273483,0.0828457037265168
"08013012603",8013012603,3384,3072,312,0.907801418439716,0.0921985815602837
"08013012607",8013012607,4258,3518,740,0.826209488022546,0.173790511977454
"08013012701",8013012701,5448,5095,353,0.935205580029369,0.0647944199706314
"08013012800",8013012800,10822,9874,948,0.912400665311403,0.0875993346885973
"08013013005",8013013005,3084,2833,251,0.918612191958495,0.0813878080415046
"08013013202",8013013202,1375,1313,62,0.954909090909091,0.0450909090909091
"08013013208",8013013208,5755,5288,467,0.918853171155517,0.0811468288444831
"08013013212",8013013212,4345,3723,622,0.856846950517837,0.143153049482163
"08013013213",8013013213,7271,5911,1360,0.812955576949525,0.187044423050475
"08013013302",8013013302,5132,4627,505,0.901597817614965,0.0984021823850351
"08013013307",8013013307,3604,3016,588,0.83684794672586,0.16315205327414
"08013013401",8013013401,3275,2499,776,0.763053435114504,0.236946564885496
"08013013508",8013013508,6575,5540,1035,0.842585551330798,0.157414448669202
"08013013702",8013013702,5952,5694,258,0.956653225806452,0.0433467741935484
"08013061400",8013061400,3990,3038,952,0.76140350877193,0.23859649122807
"08014030300",8014030300,3707,3338,369,0.900458591853251,0.0995414081467494
"08014030500",8014030500,5911,4888,1023,0.826932837083404,0.173067162916596
"08014030700",8014030700,2988,2501,487,0.837014725568942,0.162985274431058
"08014031000",8014031000,4841,4206,635,0.868828754389589,0.131171245610411
"08031000201",8031000201,3874,2560,1314,0.660815694372741,0.339184305627259
"08031000302",8031000302,4036,3524,512,0.873141724479683,0.126858275520317
"08031000303",8031000303,4504,3921,583,0.870559502664298,0.129440497335702
"08031000402",8031000402,5314,4260,1054,0.801656003010915,0.198343996989085
"08031000502",8031000502,5424,3917,1507,0.722160766961652,0.277839233038348
"08031000702",8031000702,5574,3188,2386,0.571941155364191,0.428058844635809
"08031000800",8031000800,1448,542,906,0.374309392265193,0.625690607734807
"08031000902",8031000902,5376,3402,1974,0.6328125,0.3671875
"08031000903",8031000903,6111,3615,2496,0.591556210112911,0.408443789887089
"08031000904",8031000904,5127,2958,2169,0.57694558221182,0.42305441778818
"08031001102",8031001102,3115,2305,810,0.739967897271268,0.260032102728732
"08031001302",8031001302,3926,2589,1337,0.659449821701477,0.340550178298523
"08031001403",8031001403,2218,1694,524,0.763751127141569,0.236248872858431
"08031001500",8031001500,3687,2210,1477,0.599403308923244,0.400596691076756
"08031001600",8031001600,7685,5646,2039,0.734677944046844,0.265322055953156
"08031001800",8031001800,3209,2363,846,0.736366469305079,0.263633530694921
"08031001901",8031001901,2910,1362,1548,0.468041237113402,0.531958762886598
"08031002402",8031002402,1687,1056,631,0.625963248369887,0.374036751630113
"08031002702",8031002702,5323,4599,724,0.863986473792974,0.136013526207026
"08031002703",8031002703,4785,4037,748,0.84367816091954,0.15632183908046
"08031002902",8031002902,3791,3574,217,0.942759166446848,0.0572408335531522
"08031003002",8031003002,2553,2284,269,0.894633764198982,0.105366235801018
"08031003101",8031003101,1455,884,571,0.607560137457045,0.392439862542955
"08031003500",8031003500,6401,3209,3192,0.501327917512889,0.498672082487111
"08031003602",8031003602,4337,1752,2585,0.403965875028822,0.596034124971178
"08031003603",8031003603,3106,1124,1982,0.361880231809401,0.638119768190599
"08031003702",8031003702,4357,3762,595,0.863438145512968,0.136561854487032
"08031004002",8031004002,3133,2967,166,0.947015639961698,0.052984360038302
"08031004003",8031004003,4121,3636,485,0.882310118903179,0.117689881096821
"08031004004",8031004004,1808,1627,181,0.899889380530973,0.100110619469027
"08031004102",8031004102,4173,1110,3063,0.265995686556434,0.734004313443566
"08031004103",8031004103,5093,2982,2111,0.585509522874534,0.414490477125466
"08031004104",8031004104,4289,1693,2596,0.394730706458382,0.605269293541618
"08031004403",8031004403,4213,2271,1942,0.539045810586281,0.460954189413719
"08031004506",8031004506,3450,1611,1839,0.46695652173913,0.53304347826087
"08031004801",8031004801,2858,2111,747,0.738628411476557,0.261371588523443
"08031005002",8031005002,6612,4117,2495,0.622655777374471,0.377344222625529
"08031007037",8031007037,3763,1790,1973,0.475684294445921,0.524315705554079
"08031008388",8031008388,6962,3301,3661,0.474145360528584,0.525854639471416
"08031012010",8031012010,4995,4309,686,0.862662662662663,0.137337337337337
"08031012014",8031012014,6137,5087,1050,0.828906631904839,0.171093368095161
"08031015400",8031015400,3934,3130,804,0.795627859684799,0.204372140315201
"08035013901",8035013901,6540,6126,414,0.936697247706422,0.063302752293578
"08035014006",8035014006,5205,4575,630,0.878962536023055,0.121037463976945
"08035014013",8035014013,3742,3456,286,0.923570283270978,0.0764297167290219
"08035014109",8035014109,2259,2119,140,0.938025675077468,0.0619743249225321
"08035014123",8035014123,3087,2679,408,0.867832847424684,0.132167152575316
"08035014132",8035014132,5726,5066,660,0.884736290604261,0.115263709395739
"08035014139",8035014139,4052,3516,536,0.867719644619941,0.132280355380059
"08035014140",8035014140,5531,4909,622,0.887542939793889,0.112457060206111
"08035014504",8035014504,4647,4129,518,0.888530234559931,0.111469765440069
"08035014602",8035014602,2254,2171,83,0.963176574977817,0.0368234250221828
"08039961208",8039961208,3208,3064,144,0.955112219451372,0.0448877805486284
"08047013800",8047013800,5441,5157,284,0.94780371255284,0.0521962874471604
"08059009806",8059009806,3541,3382,159,0.95509743010449,0.0449025698955098
"08059009808",8059009808,5714,5331,383,0.932971648582429,0.0670283514175709
"08059009823",8059009823,4659,4177,482,0.896544322816055,0.103455677183945
"08059009831",8059009831,2190,1804,386,0.823744292237443,0.176255707762557
"08059009832",8059009832,2501,2134,367,0.853258696521391,0.146741303478609
"08059009847",8059009847,3269,3161,108,0.966962373814622,0.0330376261853778
"08059009849",8059009849,5718,5136,582,0.898216159496327,0.101783840503673
"08059009850",8059009850,2553,2426,127,0.950254602428515,0.0497453975714846
"08059009851",8059009851,3908,3690,218,0.944216990788127,0.0557830092118731
"08059010206",8059010206,3942,3547,395,0.899797057331304,0.100202942668696
"08059010405",8059010405,2514,2028,486,0.806682577565632,0.193317422434368
"08059010504",8059010504,2835,2677,158,0.944268077601411,0.055731922398589
"08059010701",8059010701,3905,3485,420,0.892445582586428,0.107554417413572
"08059010902",8059010902,2310,1826,484,0.79047619047619,0.20952380952381
"08059011202",8059011202,4567,4041,526,0.884825925114955,0.115174074885045
"08059011708",8059011708,4074,3724,350,0.914089347079038,0.0859106529209622
"08059011709",8059011709,3362,2911,451,0.865853658536585,0.134146341463415
"08059011720",8059011720,5177,4693,484,0.906509561522117,0.093490438477883
"08059011723",8059011723,3110,2683,427,0.862700964630225,0.137299035369775
"08059011728",8059011728,2566,2316,250,0.90257209664848,0.0974279033515199
"08059011732",8059011732,4331,3671,660,0.847610251673978,0.152389748326022
"08059011804",8059011804,3915,3085,830,0.787994891443167,0.212005108556833
"08059011904",8059011904,2030,1744,286,0.859113300492611,0.140886699507389
"08059012026",8059012026,3368,3238,130,0.961401425178147,0.0385985748218527
"08059012036",8059012036,3707,3476,231,0.937685459940653,0.0623145400593472
"08059012045",8059012045,5909,5339,570,0.903536977491961,0.0964630225080386
"08059012049",8059012049,3752,3406,346,0.907782515991471,0.0922174840085288
"08059012054",8059012054,4150,3820,330,0.920481927710843,0.0795180722891566
"08059012057",8059012057,5705,5256,449,0.921297107800175,0.0787028921998247
"08059012059",8059012059,3245,2961,284,0.912480739599384,0.0875192604006163
"08059015900",8059015900,3411,2721,690,0.797713280562885,0.202286719437115
"08123001907",8123001907,2775,2149,626,0.774414414414414,0.225585585585586
"08123002012",8123002012,892,783,109,0.87780269058296,0.12219730941704
"08123002017",8123002017,600,567,33,0.945,0.055
"08123002021",8123002021,622,565,57,0.908360128617363,0.0916398713826366
"08123002502",8123002502,5656,5053,603,0.893387553041018,0.106612446958982
