"GEOID","GEO.display.label","pop","pop.white","pop.not.white","pct.white","pct.not.white"
"47001020100","Census Tract 201, Anderson County, Tennessee",3530,2106,1424,0.596600566572238,0.403399433427762
"47001020201","Census Tract 202.01, Anderson County, Tennessee",3642,2885,757,0.79214717188358,0.20785282811642
"47001020202","Census Tract 202.02, Anderson County, Tennessee",4254,3699,555,0.869534555712271,0.130465444287729
"47001020300","Census Tract 203, Anderson County, Tennessee",3985,3417,568,0.857465495608532,0.142534504391468
"47001020400","Census Tract 204, Anderson County, Tennessee",4476,4062,414,0.907506702412869,0.0924932975871313
"47001020500","Census Tract 205, Anderson County, Tennessee",3218,2875,343,0.893412057178372,0.106587942821628
"47001020600","Census Tract 206, Anderson County, Tennessee",2582,2317,265,0.897366382649109,0.102633617350891
"47001020700","Census Tract 207, Anderson County, Tennessee",1714,1667,47,0.972578763127188,0.0274212368728122
"47001020800","Census Tract 208, Anderson County, Tennessee",5043,5005,38,0.992464802696807,0.00753519730319252
"47001020901","Census Tract 209.01, Anderson County, Tennessee",5495,5473,22,0.995996360327571,0.00400363967242945
"47001020902","Census Tract 209.02, Anderson County, Tennessee",5796,5635,161,0.972222222222222,0.0277777777777778
"47001021000","Census Tract 210, Anderson County, Tennessee",5935,5835,100,0.983150800336984,0.016849199663016
"47001021100","Census Tract 211, Anderson County, Tennessee",3966,3637,329,0.917044881492688,0.0829551185073122
"47001021201","Census Tract 212.01, Anderson County, Tennessee",5072,4750,322,0.936514195583596,0.0634858044164038
"47001021202","Census Tract 212.02, Anderson County, Tennessee",4912,4865,47,0.990431596091205,0.00956840390879476
"47001021301","Census Tract 213.01, Anderson County, Tennessee",3528,3467,61,0.982709750566893,0.0172902494331065
"47001021302","Census Tract 213.02, Anderson County, Tennessee",7109,7100,9,0.998733999155999,0.00126600084400053
"47003950100","Census Tract 9501, Bedford County, Tennessee",3830,3560,270,0.929503916449086,0.0704960835509139
"47003950200","Census Tract 9502, Bedford County, Tennessee",6968,6670,298,0.957233065442021,0.0427669345579793
"47003950300","Census Tract 9503, Bedford County, Tennessee",3583,3550,33,0.990789840915434,0.00921015908456602
"47003950401","Census Tract 9504.01, Bedford County, Tennessee",5119,4126,993,0.806016800156281,0.193983199843719
"47003950402","Census Tract 9504.02, Bedford County, Tennessee",6110,4408,1702,0.721440261865794,0.278559738134206
"47003950500","Census Tract 9505, Bedford County, Tennessee",6512,4771,1741,0.73264742014742,0.26735257985258
"47003950600","Census Tract 9506, Bedford County, Tennessee",6677,4846,1831,0.725775048674554,0.274224951325446
"47003950700","Census Tract 9507, Bedford County, Tennessee",2411,2376,35,0.985483201990875,0.0145167980091249
"47003950800","Census Tract 9508, Bedford County, Tennessee",2962,2782,180,0.939230249831195,0.0607697501688048
"47005963000","Census Tract 9630, Benton County, Tennessee",3650,3566,84,0.976986301369863,0.023013698630137
"47005963100","Census Tract 9631, Benton County, Tennessee",2982,2971,11,0.996311200536553,0.00368879946344736
"47005963200","Census Tract 9632, Benton County, Tennessee",2155,2100,55,0.974477958236659,0.0255220417633411
"47005963300","Census Tract 9633, Benton County, Tennessee",3683,3327,356,0.903339668748303,0.096660331251697
"47005963400","Census Tract 9634, Benton County, Tennessee",3986,3849,137,0.965629703963874,0.0343702960361264
"47007953000","Census Tract 9530, Bledsoe County, Tennessee",3149,3009,140,0.955541441727533,0.0444585582724675
"47007953100","Census Tract 9531, Bledsoe County, Tennessee",5230,5055,175,0.966539196940727,0.0334608030592735
"47007953200","Census Tract 9532, Bledsoe County, Tennessee",4567,3995,572,0.874753667615503,0.125246332384497
"47009010100","Census Tract 101, Blount County, Tennessee",2868,1440,1428,0.502092050209205,0.497907949790795
"47009010200","Census Tract 102, Blount County, Tennessee",4698,4358,340,0.927628778203491,0.0723712217965091
"47009010301","Census Tract 103.01, Blount County, Tennessee",5759,4537,1222,0.787810383747178,0.212189616252822
"47009010302","Census Tract 103.02, Blount County, Tennessee",3418,3204,214,0.937390286717379,0.0626097132826214
"47009010400","Census Tract 104, Blount County, Tennessee",3353,3154,199,0.94065016403221,0.0593498359677901
"47009010500","Census Tract 105, Blount County, Tennessee",2677,2166,511,0.809114680612626,0.190885319387374
"47009010600","Census Tract 106, Blount County, Tennessee",4362,3957,405,0.907152682255846,0.0928473177441541
"47009010700","Census Tract 107, Blount County, Tennessee",4799,4036,763,0.841008543446551,0.158991456553449
"47009010800","Census Tract 108, Blount County, Tennessee",3241,2770,471,0.854674483184202,0.145325516815798
"47009010900","Census Tract 109, Blount County, Tennessee",5785,5470,315,0.945548833189283,0.0544511668107174
"47009011001","Census Tract 110.01, Blount County, Tennessee",5154,4886,268,0.948001552192472,0.0519984478075282
"47009011002","Census Tract 110.02, Blount County, Tennessee",3832,3808,24,0.993736951983299,0.00626304801670141
"47009011101","Census Tract 111.01, Blount County, Tennessee",4993,4792,201,0.959743641097537,0.0402563589024635
"47009011102","Census Tract 111.02, Blount County, Tennessee",8502,8255,247,0.970948012232416,0.0290519877675841
"47009011200","Census Tract 112, Blount County, Tennessee",7135,6430,705,0.901191310441486,0.0988086895585144
"47009011301","Census Tract 113.01, Blount County, Tennessee",5879,5639,240,0.95917673073652,0.0408232692634802
"47009011302","Census Tract 113.02, Blount County, Tennessee",5132,5107,25,0.995128604832424,0.00487139516757595
"47009011401","Census Tract 114.01, Blount County, Tennessee",1883,1852,31,0.983536909187467,0.0164630908125332
"47009011402","Census Tract 114.02, Blount County, Tennessee",3924,3893,31,0.992099898063201,0.00790010193679913
"47009011501","Census Tract 115.01, Blount County, Tennessee",1956,1923,33,0.983128834355828,0.0168711656441718
"47009011502","Census Tract 115.02, Blount County, Tennessee",4468,4392,76,0.982990152193375,0.0170098478066248
"47009011503","Census Tract 115.03, Blount County, Tennessee",6906,6799,107,0.984506226469737,0.0154937735302635
"47009011602","Census Tract 116.02, Blount County, Tennessee",8781,8583,198,0.977451315339938,0.0225486846600615
"47009011603","Census Tract 116.03, Blount County, Tennessee",4830,4769,61,0.987370600414079,0.0126293995859214
"47009011604","Census Tract 116.04, Blount County, Tennessee",3355,3024,331,0.901341281669151,0.0986587183308495
"47009011605","Census Tract 116.05, Blount County, Tennessee",3393,3322,71,0.979074565281462,0.0209254347185381
"47009980100","Census Tract 9801, Blount County, Tennessee",24,24,0,1,0
"47009980200","Census Tract 9802, Blount County, Tennessee",33,33,0,1,0
"47011010100","Census Tract 101, Bradley County, Tennessee",4821,4251,570,0.881767268201618,0.118232731798382
"47011010200","Census Tract 102, Bradley County, Tennessee",4754,4367,387,0.918594867480017,0.0814051325199832
"47011010300","Census Tract 103, Bradley County, Tennessee",2631,2397,234,0.911060433295325,0.0889395667046751
"47011010400","Census Tract 104, Bradley County, Tennessee",2433,1727,706,0.709823263460748,0.290176736539252
"47011010500","Census Tract 105, Bradley County, Tennessee",3429,3092,337,0.901720618256051,0.0982793817439487
"47011010600","Census Tract 106, Bradley County, Tennessee",3034,2629,405,0.866512854317732,0.133487145682268
"47011010700","Census Tract 107, Bradley County, Tennessee",4929,4225,704,0.857171840129844,0.142828159870156
"47011010800","Census Tract 108, Bradley County, Tennessee",3600,2953,647,0.820277777777778,0.179722222222222
"47011010900","Census Tract 109, Bradley County, Tennessee",2870,2809,61,0.978745644599303,0.0212543554006969
"47011011000","Census Tract 110, Bradley County, Tennessee",5755,5483,272,0.952736750651607,0.0472632493483927
"47011011100","Census Tract 111, Bradley County, Tennessee",9202,8772,430,0.953271028037383,0.0467289719626168
"47011011201","Census Tract 112.01, Bradley County, Tennessee",5817,5328,489,0.915936049510057,0.0840639504899433
"47011011202","Census Tract 112.02, Bradley County, Tennessee",8318,7520,798,0.904063476797307,0.095936523202693
"47011011300","Census Tract 113, Bradley County, Tennessee",7180,6913,267,0.962813370473538,0.0371866295264623
"47011011401","Census Tract 114.01, Bradley County, Tennessee",8158,7375,783,0.904020593282667,0.0959794067173326
"47011011402","Census Tract 114.02, Bradley County, Tennessee",2996,2628,368,0.87716955941255,0.12283044058745
"47011011500","Census Tract 115, Bradley County, Tennessee",7410,7255,155,0.979082321187584,0.0209176788124157
"47011011601","Census Tract 116.01, Bradley County, Tennessee",5150,5038,112,0.978252427184466,0.021747572815534
"47011011602","Census Tract 116.02, Bradley County, Tennessee",4705,4705,0,1,0
"47013950100","Census Tract 9501, Campbell County, Tennessee",3424,3377,47,0.986273364485981,0.0137266355140186
"47013950200","Census Tract 9502, Campbell County, Tennessee",2665,2519,146,0.945215759849906,0.0547842401500938
"47013950300","Census Tract 9503, Campbell County, Tennessee",1726,1714,12,0.993047508690614,0.00695249130938591
"47013950400","Census Tract 9504, Campbell County, Tennessee",4291,4137,154,0.964110929853181,0.035889070146819
"47013950500","Census Tract 9505, Campbell County, Tennessee",5304,5267,37,0.993024132730015,0.00697586726998489
"47013950600","Census Tract 9506, Campbell County, Tennessee",4640,4611,29,0.99375,0.00624999999999998
"47013950700","Census Tract 9507, Campbell County, Tennessee",5077,4992,85,0.983257829426827,0.0167421705731732
"47013950800","Census Tract 9508, Campbell County, Tennessee",2089,2076,13,0.993776926759215,0.00622307324078508
"47013950900","Census Tract 9509, Campbell County, Tennessee",3275,3249,26,0.99206106870229,0.00793893129770995
"47013951000","Census Tract 9510, Campbell County, Tennessee",2500,2476,24,0.9904,0.00960000000000005
"47013951100","Census Tract 9511, Campbell County, Tennessee",5632,5357,275,0.951171875,0.048828125
"47015960100","Census Tract 9601, Cannon County, Tennessee",4044,3934,110,0.972799208704253,0.0272007912957468
"47015960200","Census Tract 9602, Cannon County, Tennessee",6391,6073,318,0.950242528555782,0.0497574714442184
"47015960300","Census Tract 9603, Cannon County, Tennessee",3196,3142,54,0.983103879849812,0.0168961201501877
"47017962000","Census Tract 9620, Carroll County, Tennessee",4128,3696,432,0.895348837209302,0.104651162790698
"47017962100","Census Tract 9621, Carroll County, Tennessee",7251,5996,1255,0.826920424768997,0.173079575231003
"47017962201","Census Tract 9622.01, Carroll County, Tennessee",3721,2837,884,0.762429454447729,0.237570545552271
"47017962202","Census Tract 9622.02, Carroll County, Tennessee",4247,4081,166,0.960913586060749,0.0390864139392513
"47017962300","Census Tract 9623, Carroll County, Tennessee",4544,4045,499,0.89018485915493,0.10981514084507
"47017962400","Census Tract 9624, Carroll County, Tennessee",2489,2312,177,0.928887103254319,0.071112896745681
"47017962500","Census Tract 9625, Carroll County, Tennessee",2264,2010,254,0.887809187279152,0.112190812720848
"47019070100","Census Tract 701, Carter County, Tennessee",1894,1869,25,0.986800422386484,0.0131995776135164
"47019070200","Census Tract 702, Carter County, Tennessee",3844,3780,64,0.983350676378772,0.0166493236212278
"47019070300","Census Tract 703, Carter County, Tennessee",5554,5170,384,0.930860640979474,0.0691393590205257
"47019070400","Census Tract 704, Carter County, Tennessee",2215,2080,135,0.939051918735892,0.0609480812641083
"47019070500","Census Tract 705, Carter County, Tennessee",4351,4290,61,0.985980234428867,0.014019765571133
"47019070600","Census Tract 706, Carter County, Tennessee",2567,2513,54,0.978963770938839,0.0210362290611609
"47019070700","Census Tract 707, Carter County, Tennessee",3235,3113,122,0.962287480680062,0.0377125193199381
"47019070800","Census Tract 708, Carter County, Tennessee",3172,2962,210,0.933795712484237,0.0662042875157629
"47019070900","Census Tract 709, Carter County, Tennessee",3677,3336,341,0.907261354364971,0.0927386456350285
"47019071000","Census Tract 710, Carter County, Tennessee",2720,2691,29,0.989338235294118,0.0106617647058823
"47019071100","Census Tract 711, Carter County, Tennessee",1871,1829,42,0.977552111170497,0.022447888829503
"47019071200","Census Tract 712, Carter County, Tennessee",3921,3817,104,0.973476154042336,0.0265238459576639
"47019071300","Census Tract 713, Carter County, Tennessee",7048,6970,78,0.988933030646992,0.011066969353008
"47019071400","Census Tract 714, Carter County, Tennessee",3986,3870,116,0.970898143502258,0.0291018564977421
"47019071500","Census Tract 715, Carter County, Tennessee",2147,2089,58,0.972985561248253,0.0270144387517466
"47019071600","Census Tract 716, Carter County, Tennessee",1643,1605,38,0.976871576384662,0.0231284236153378
"47019071700","Census Tract 717, Carter County, Tennessee",3865,3698,167,0.956791720569211,0.0432082794307891
"47021070102","Census Tract 701.02, Cheatham County, Tennessee",4095,3982,113,0.972405372405372,0.0275946275946276
"47021070103","Census Tract 701.03, Cheatham County, Tennessee",3281,3261,20,0.993904297470283,0.00609570252971658
"47021070104","Census Tract 701.04, Cheatham County, Tennessee",4795,4628,167,0.965172054223149,0.0348279457768509
"47021070201","Census Tract 702.01, Cheatham County, Tennessee",3962,3741,221,0.9442200908632,0.0557799091367996
"47021070202","Census Tract 702.02, Cheatham County, Tennessee",5283,5014,269,0.949081961007004,0.0509180389929964
"47021070203","Census Tract 702.03, Cheatham County, Tennessee",3572,3458,114,0.968085106382979,0.0319148936170213
"47021070300","Census Tract 703, Cheatham County, Tennessee",3714,3558,156,0.957996768982229,0.0420032310177706
"47021070401","Census Tract 704.01, Cheatham County, Tennessee",2706,2476,230,0.9150036954915,0.0849963045084996
"47021070402","Census Tract 704.02, Cheatham County, Tennessee",7401,7170,231,0.968788001621403,0.0312119983785974
"47023970100","Census Tract 9701, Chester County, Tennessee",5531,4809,722,0.869463026577472,0.130536973422528
"47023970200","Census Tract 9702, Chester County, Tennessee",5354,4399,955,0.821628688830781,0.178371311169219
"47023970300","Census Tract 9703, Chester County, Tennessee",5908,5594,314,0.94685172647258,0.0531482735274205
"47025970100","Census Tract 9701, Claiborne County, Tennessee",2764,2764,0,1,0
"47025970200","Census Tract 9702, Claiborne County, Tennessee",2865,2739,126,0.956020942408377,0.043979057591623
"47025970300","Census Tract 9703, Claiborne County, Tennessee",4417,4306,111,0.974869821145574,0.025130178854426
"47025970400","Census Tract 9704, Claiborne County, Tennessee",667,667,0,1,0
"47025970500","Census Tract 9705, Claiborne County, Tennessee",3113,2945,168,0.946032765820752,0.0539672341792483
"47025970600","Census Tract 9706, Claiborne County, Tennessee",4508,4493,15,0.996672582076309,0.00332741792369118
"47025970700","Census Tract 9707, Claiborne County, Tennessee",6460,6288,172,0.973374613003096,0.026625386996904
"47025970800","Census Tract 9708, Claiborne County, Tennessee",3262,3183,79,0.975781729000613,0.0242182709993869
"47025970900","Census Tract 9709, Claiborne County, Tennessee",3845,3664,181,0.952925877763329,0.047074122236671
"47027955000","Census Tract 9550, Clay County, Tennessee",4803,4663,140,0.970851551113887,0.0291484488861129
"47027955100","Census Tract 9551, Clay County, Tennessee",3085,3072,13,0.995786061588331,0.00421393841166939
"47029920100","Census Tract 9201, Cocke County, Tennessee",4001,3923,78,0.980504873781555,0.0194951262184454
"47029920200","Census Tract 9202, Cocke County, Tennessee",5304,4954,350,0.934012066365008,0.0659879336349924
"47029920300","Census Tract 9203, Cocke County, Tennessee",3969,3845,124,0.968757873519778,0.0312421264802217
"47029920400","Census Tract 9204, Cocke County, Tennessee",1860,1824,36,0.980645161290323,0.0193548387096775
"47029920501","Census Tract 9205.01, Cocke County, Tennessee",5614,5213,401,0.928571428571429,0.0714285714285714
"47029920502","Census Tract 9205.02, Cocke County, Tennessee",5179,5106,73,0.9859046147905,0.0140953852094999
"47029920600","Census Tract 9206, Cocke County, Tennessee",5269,4607,662,0.874359460998292,0.125640539001708
"47029920700","Census Tract 9207, Cocke County, Tennessee",4240,4045,195,0.954009433962264,0.0459905660377359
"47029980100","Census Tract 9801, Cocke County, Tennessee",37,37,0,1,0
"47031970100","Census Tract 9701, Coffee County, Tennessee",3893,3653,240,0.938350886206011,0.0616491137939892
"47031970200","Census Tract 9702, Coffee County, Tennessee",6666,6331,335,0.94974497449745,0.0502550255025502
"47031970300","Census Tract 9703, Coffee County, Tennessee",1936,1925,11,0.994318181818182,0.00568181818181823
"47031970400","Census Tract 9704, Coffee County, Tennessee",5957,5526,431,0.927648145039449,0.0723518549605506
"47031970500","Census Tract 9705, Coffee County, Tennessee",5356,4784,572,0.893203883495146,0.106796116504854
"47031970600","Census Tract 9706, Coffee County, Tennessee",4160,4044,116,0.972115384615385,0.0278846153846154
"47031970700","Census Tract 9707, Coffee County, Tennessee",3872,3752,120,0.96900826446281,0.03099173553719
"47031970801","Census Tract 9708.01, Coffee County, Tennessee",3959,3404,555,0.85981308411215,0.14018691588785
"47031970802","Census Tract 9708.02, Coffee County, Tennessee",6054,5479,575,0.905021473406013,0.0949785265939874
"47031970900","Census Tract 9709, Coffee County, Tennessee",3930,3300,630,0.83969465648855,0.16030534351145
"47031971000","Census Tract 9710, Coffee County, Tennessee",6561,6068,493,0.924859015393995,0.0751409846060052
"47033961000","Census Tract 9610, Crockett County, Tennessee",2120,1825,295,0.860849056603774,0.139150943396226
"47033961100","Census Tract 9611, Crockett County, Tennessee",4185,3566,619,0.852090800477897,0.147909199522103
"47033961200","Census Tract 9612, Crockett County, Tennessee",2084,1921,163,0.921785028790787,0.0782149712092131
"47033961300","Census Tract 9613, Crockett County, Tennessee",2532,1722,810,0.680094786729858,0.319905213270142
"47033961400","Census Tract 9614, Crockett County, Tennessee",3603,2849,754,0.790729947266167,0.209270052733833
"47035970101","Census Tract 9701.01, Cumberland County, Tennessee",2853,2797,56,0.98037153873116,0.0196284612688398
"47035970102","Census Tract 9701.02, Cumberland County, Tennessee",5514,5436,78,0.985854189336235,0.014145810663765
"47035970200","Census Tract 9702, Cumberland County, Tennessee",5606,5465,141,0.974848376739208,0.025151623260792
"47035970301","Census Tract 9703.01, Cumberland County, Tennessee",2947,2935,12,0.995928062436376,0.00407193756362401
"47035970302","Census Tract 9703.02, Cumberland County, Tennessee",4736,4631,105,0.977829391891892,0.0221706081081081
"47035970400","Census Tract 9704, Cumberland County, Tennessee",5278,5005,273,0.948275862068966,0.0517241379310345
"47035970501","Census Tract 9705.01, Cumberland County, Tennessee",2855,2824,31,0.989141856392294,0.0108581436077058
"47035970502","Census Tract 9705.02, Cumberland County, Tennessee",4236,3971,265,0.937440982058546,0.0625590179414542
"47035970601","Census Tract 9706.01, Cumberland County, Tennessee",5062,4873,189,0.96266297905966,0.0373370209403397
"47035970602","Census Tract 9706.02, Cumberland County, Tennessee",3088,2982,106,0.965673575129534,0.0343264248704663
"47035970603","Census Tract 9706.03, Cumberland County, Tennessee",1948,1948,0,1,0
"47035970701","Census Tract 9707.01, Cumberland County, Tennessee",2198,2163,35,0.984076433121019,0.0159235668789809
"47035970702","Census Tract 9707.02, Cumberland County, Tennessee",4634,4570,64,0.986189037548554,0.0138109624514459
"47035970800","Census Tract 9708, Cumberland County, Tennessee",4022,3992,30,0.992541024365987,0.00745897563401288
"47037010103","Census Tract 101.03, Davidson County, Tennessee",2176,1872,304,0.860294117647059,0.139705882352941
"47037010104","Census Tract 101.04, Davidson County, Tennessee",3475,3173,302,0.913093525179856,0.0869064748201439
"47037010105","Census Tract 101.05, Davidson County, Tennessee",4322,1221,3101,0.28250809810273,0.71749190189727
"47037010106","Census Tract 101.06, Davidson County, Tennessee",2300,639,1661,0.277826086956522,0.722173913043478
"47037010201","Census Tract 102.01, Davidson County, Tennessee",3987,1939,2048,0.486330574366692,0.513669425633308
"47037010202","Census Tract 102.02, Davidson County, Tennessee",3826,3563,263,0.931259801359122,0.0687401986408782
"47037010301","Census Tract 103.01, Davidson County, Tennessee",3386,2647,739,0.781748375664501,0.218251624335499
"47037010302","Census Tract 103.02, Davidson County, Tennessee",1980,1426,554,0.72020202020202,0.27979797979798
"47037010303","Census Tract 103.03, Davidson County, Tennessee",4677,3282,1395,0.701731879409878,0.298268120590122
"47037010401","Census Tract 104.01, Davidson County, Tennessee",4640,3246,1394,0.699568965517241,0.300431034482759
"47037010402","Census Tract 104.02, Davidson County, Tennessee",5622,3684,1938,0.655282817502668,0.344717182497332
"47037010501","Census Tract 105.01, Davidson County, Tennessee",5278,4804,474,0.910193255020841,0.0898067449791587
"47037010502","Census Tract 105.02, Davidson County, Tennessee",4344,3562,782,0.819981583793739,0.180018416206261
"47037010601","Census Tract 106.01, Davidson County, Tennessee",4123,2901,1222,0.70361387339316,0.29638612660684
"47037010602","Census Tract 106.02, Davidson County, Tennessee",3251,1742,1509,0.53583512765303,0.46416487234697
"47037010701","Census Tract 107.01, Davidson County, Tennessee",4155,3058,1097,0.735980746089049,0.264019253910951
"47037010702","Census Tract 107.02, Davidson County, Tennessee",3023,1865,1158,0.616936817730731,0.383063182269269
"47037010801","Census Tract 108.01, Davidson County, Tennessee",5669,2842,2827,0.501322984653378,0.498677015346622
"47037010802","Census Tract 108.02, Davidson County, Tennessee",3155,2330,825,0.73851030110935,0.26148969889065
"47037010901","Census Tract 109.01, Davidson County, Tennessee",3065,1804,1261,0.58858075040783,0.41141924959217
"47037010903","Census Tract 109.03, Davidson County, Tennessee",4478,571,3907,0.12751228226887,0.87248771773113
"47037010904","Census Tract 109.04, Davidson County, Tennessee",2699,411,2288,0.152278621711745,0.847721378288255
"47037011001","Census Tract 110.01, Davidson County, Tennessee",5884,2125,3759,0.361148878314072,0.638851121685928
"47037011002","Census Tract 110.02, Davidson County, Tennessee",2696,1524,1172,0.565281899109792,0.434718100890208
"47037011100","Census Tract 111, Davidson County, Tennessee",4283,3210,1073,0.749474667289283,0.250525332710717
"47037011200","Census Tract 112, Davidson County, Tennessee",4029,2680,1349,0.665177463390419,0.334822536609581
"47037011300","Census Tract 113, Davidson County, Tennessee",5169,1701,3468,0.329077190946024,0.670922809053976
"47037011400","Census Tract 114, Davidson County, Tennessee",5314,1422,3892,0.267595031990967,0.732404968009033
"47037011500","Census Tract 115, Davidson County, Tennessee",4140,2591,1549,0.625845410628019,0.374154589371981
"47037011600","Census Tract 116, Davidson County, Tennessee",5492,3189,2303,0.580662782228696,0.419337217771304
"47037011700","Census Tract 117, Davidson County, Tennessee",5418,3183,2235,0.587486157253599,0.412513842746401
"47037011800","Census Tract 118, Davidson County, Tennessee",2977,319,2658,0.107154853879745,0.892845146120255
"47037011900","Census Tract 119, Davidson County, Tennessee",1598,466,1132,0.291614518147685,0.708385481852315
"47037012100","Census Tract 121, Davidson County, Tennessee",2485,2211,274,0.889738430583501,0.110261569416499
"47037012200","Census Tract 122, Davidson County, Tennessee",2544,1673,871,0.657625786163522,0.342374213836478
"47037012600","Census Tract 126, Davidson County, Tennessee",1801,311,1490,0.172681843420322,0.827318156579678
"47037012701","Census Tract 127.01, Davidson County, Tennessee",5383,226,5157,0.0419840237785621,0.958015976221438
"47037012702","Census Tract 127.02, Davidson County, Tennessee",2262,390,1872,0.172413793103448,0.827586206896552
"47037012801","Census Tract 128.01, Davidson County, Tennessee",4996,579,4417,0.115892714171337,0.884107285828663
"47037012802","Census Tract 128.02, Davidson County, Tennessee",4375,1367,3008,0.312457142857143,0.687542857142857
"47037013000","Census Tract 130, Davidson County, Tennessee",2281,1098,1183,0.481367821131083,0.518632178868917
"47037013100","Census Tract 131, Davidson County, Tennessee",2043,1528,515,0.747919725893294,0.252080274106706
"47037013201","Census Tract 132.01, Davidson County, Tennessee",2930,2073,857,0.707508532423208,0.292491467576792
"47037013202","Census Tract 132.02, Davidson County, Tennessee",3205,2443,762,0.762246489859594,0.237753510140406
"47037013300","Census Tract 133, Davidson County, Tennessee",4017,2917,1100,0.726163803833707,0.273836196166293
"47037013400","Census Tract 134, Davidson County, Tennessee",3280,3150,130,0.960365853658537,0.0396341463414634
"47037013500","Census Tract 135, Davidson County, Tennessee",2087,1322,765,0.633445136559655,0.366554863440345
"47037013601","Census Tract 136.01, Davidson County, Tennessee",3543,29,3514,0.00818515382444256,0.991814846175557
"47037013602","Census Tract 136.02, Davidson County, Tennessee",2341,47,2294,0.0200768902178556,0.979923109782144
"47037013700","Census Tract 137, Davidson County, Tennessee",5990,327,5663,0.0545909849749583,0.945409015025042
"47037013800","Census Tract 138, Davidson County, Tennessee",1763,39,1724,0.0221213840045377,0.977878615995462
"47037013900","Census Tract 139, Davidson County, Tennessee",1567,28,1539,0.0178685386088066,0.982131461391193
"47037014200","Census Tract 142, Davidson County, Tennessee",2608,8,2600,0.00306748466257669,0.996932515337423
"47037014300","Census Tract 143, Davidson County, Tennessee",1954,69,1885,0.0353121801432958,0.964687819856704
"47037014400","Census Tract 144, Davidson County, Tennessee",677,50,627,0.0738552437223043,0.926144756277696
"47037014800","Census Tract 148, Davidson County, Tennessee",2588,304,2284,0.117465224111283,0.882534775888717
"47037015100","Census Tract 151, Davidson County, Tennessee",4420,3782,638,0.855656108597285,0.144343891402715
"47037015200","Census Tract 152, Davidson County, Tennessee",2684,2662,22,0.991803278688525,0.00819672131147542
"47037015300","Census Tract 153, Davidson County, Tennessee",5411,4227,1184,0.781186472001479,0.218813527998521
"47037015401","Census Tract 154.01, Davidson County, Tennessee",5527,4839,688,0.875520173692781,0.124479826307219
"47037015402","Census Tract 154.02, Davidson County, Tennessee",4334,3324,1010,0.766958929395478,0.233041070604522
"47037015404","Census Tract 154.04, Davidson County, Tennessee",3275,2773,502,0.846717557251908,0.153282442748092
"47037015405","Census Tract 154.05, Davidson County, Tennessee",4438,3756,682,0.846327174402884,0.153672825597116
"47037015501","Census Tract 155.01, Davidson County, Tennessee",3488,2706,782,0.775802752293578,0.224197247706422
"47037015502","Census Tract 155.02, Davidson County, Tennessee",4133,3523,610,0.852407452213888,0.147592547786112
"47037015609","Census Tract 156.09, Davidson County, Tennessee",3237,2560,677,0.790855730614767,0.209144269385233
"47037015610","Census Tract 156.10, Davidson County, Tennessee",8025,6649,1376,0.828535825545171,0.171464174454829
"47037015612","Census Tract 156.12, Davidson County, Tennessee",6763,3840,2923,0.567795357090049,0.432204642909951
"47037015613","Census Tract 156.13, Davidson County, Tennessee",5950,2851,3099,0.479159663865546,0.520840336134454
"47037015614","Census Tract 156.14, Davidson County, Tennessee",4059,1796,2263,0.442473515644247,0.557526484355753
"47037015615","Census Tract 156.15, Davidson County, Tennessee",4832,1982,2850,0.410182119205298,0.589817880794702
"47037015617","Census Tract 156.17, Davidson County, Tennessee",3004,2006,998,0.667776298268975,0.332223701731025
"47037015618","Census Tract 156.18, Davidson County, Tennessee",6038,2865,3173,0.474494865849619,0.525505134150381
"47037015619","Census Tract 156.19, Davidson County, Tennessee",4485,2586,1899,0.576588628762542,0.423411371237458
"47037015620","Census Tract 156.20, Davidson County, Tennessee",6610,2684,3926,0.406051437216339,0.593948562783661
"47037015622","Census Tract 156.22, Davidson County, Tennessee",3802,2912,890,0.765912677538138,0.234087322461862
"47037015623","Census Tract 156.23, Davidson County, Tennessee",5933,3822,2111,0.644193494016518,0.355806505983482
"47037015624","Census Tract 156.24, Davidson County, Tennessee",4698,3456,1242,0.735632183908046,0.264367816091954
"47037015625","Census Tract 156.25, Davidson County, Tennessee",4927,3846,1081,0.780596711995129,0.219403288004871
"47037015626","Census Tract 156.26, Davidson County, Tennessee",6436,2789,3647,0.433343691733996,0.566656308266004
"47037015627","Census Tract 156.27, Davidson County, Tennessee",2834,1486,1348,0.524347212420607,0.475652787579393
"47037015628","Census Tract 156.28, Davidson County, Tennessee",2845,1519,1326,0.533919156414763,0.466080843585237
"47037015629","Census Tract 156.29, Davidson County, Tennessee",3407,1811,1596,0.531552685647197,0.468447314352803
"47037015630","Census Tract 156.30, Davidson County, Tennessee",2375,788,1587,0.331789473684211,0.668210526315789
"47037015631","Census Tract 156.31, Davidson County, Tennessee",7390,4369,3021,0.591204330175913,0.408795669824087
"47037015700","Census Tract 157, Davidson County, Tennessee",1616,1301,315,0.805074257425743,0.194925742574257
"47037015802","Census Tract 158.02, Davidson County, Tennessee",6814,4453,2361,0.653507484590549,0.346492515409451
"47037015803","Census Tract 158.03, Davidson County, Tennessee",3120,2526,594,0.809615384615385,0.190384615384615
"47037015804","Census Tract 158.04, Davidson County, Tennessee",4002,2465,1537,0.615942028985507,0.384057971014493
"47037015900","Census Tract 159, Davidson County, Tennessee",2596,1884,712,0.725731895223421,0.274268104776579
"47037016000","Census Tract 160, Davidson County, Tennessee",494,33,461,0.0668016194331984,0.933198380566802
"47037016100","Census Tract 161, Davidson County, Tennessee",2172,885,1287,0.407458563535912,0.592541436464088
"47037016200","Census Tract 162, Davidson County, Tennessee",3346,905,2441,0.270472205618649,0.729527794381351
"47037016300","Census Tract 163, Davidson County, Tennessee",2272,605,1667,0.266285211267606,0.733714788732394
"47037016400","Census Tract 164, Davidson County, Tennessee",2634,2364,270,0.89749430523918,0.10250569476082
"47037016500","Census Tract 165, Davidson County, Tennessee",5079,4068,1011,0.800945067926757,0.199054932073243
"47037016600","Census Tract 166, Davidson County, Tennessee",2086,1403,683,0.672579098753595,0.327420901246405
"47037016700","Census Tract 167, Davidson County, Tennessee",5408,4575,833,0.845968934911243,0.154031065088757
"47037016800","Census Tract 168, Davidson County, Tennessee",4049,3536,513,0.873302049888861,0.126697950111139
"47037016900","Census Tract 169, Davidson County, Tennessee",4455,4055,400,0.910213243546577,0.0897867564534232
"47037017000","Census Tract 170, Davidson County, Tennessee",2450,1555,895,0.63469387755102,0.36530612244898
"47037017100","Census Tract 171, Davidson County, Tennessee",1840,958,882,0.520652173913044,0.479347826086956
"47037017200","Census Tract 172, Davidson County, Tennessee",1270,1111,159,0.874803149606299,0.125196850393701
"47037017300","Census Tract 173, Davidson County, Tennessee",3906,1983,1923,0.507680491551459,0.492319508448541
"47037017401","Census Tract 174.01, Davidson County, Tennessee",2268,1203,1065,0.53042328042328,0.46957671957672
"47037017402","Census Tract 174.02, Davidson County, Tennessee",5890,4150,1740,0.704584040747029,0.295415959252971
"47037017500","Census Tract 175, Davidson County, Tennessee",2780,2373,407,0.853597122302158,0.146402877697842
"47037017701","Census Tract 177.01, Davidson County, Tennessee",1991,1889,102,0.948769462581617,0.0512305374183827
"47037017702","Census Tract 177.02, Davidson County, Tennessee",4860,4519,341,0.929835390946502,0.070164609053498
"47037017800","Census Tract 178, Davidson County, Tennessee",4992,4412,580,0.883814102564103,0.116185897435897
"47037017901","Census Tract 179.01, Davidson County, Tennessee",4282,3976,306,0.928538066324148,0.0714619336758524
"47037017902","Census Tract 179.02, Davidson County, Tennessee",4421,4243,178,0.959737615923999,0.0402623840760009
"47037018000","Census Tract 180, Davidson County, Tennessee",4723,4281,442,0.906415413931823,0.093584586068177
"47037018101","Census Tract 181.01, Davidson County, Tennessee",4403,2746,1657,0.623665682489212,0.376334317510788
"47037018102","Census Tract 181.02, Davidson County, Tennessee",3632,3369,263,0.927588105726872,0.0724118942731278
"47037018201","Census Tract 182.01, Davidson County, Tennessee",3119,2736,383,0.877204232125681,0.122795767874319
"47037018202","Census Tract 182.02, Davidson County, Tennessee",6222,4531,1691,0.72822243651559,0.27177756348441
"47037018203","Census Tract 182.03, Davidson County, Tennessee",1448,1401,47,0.967541436464088,0.0324585635359116
"47037018301","Census Tract 183.01, Davidson County, Tennessee",6954,5715,1239,0.821829163071613,0.178170836928387
"47037018302","Census Tract 183.02, Davidson County, Tennessee",2764,2497,267,0.903400868306802,0.0965991316931982
"47037018401","Census Tract 184.01, Davidson County, Tennessee",5982,4975,1007,0.831661651621531,0.168338348378469
"47037018404","Census Tract 184.04, Davidson County, Tennessee",4182,3767,415,0.900765184122429,0.0992348158775705
"47037018405","Census Tract 184.05, Davidson County, Tennessee",5122,4843,279,0.945529090199141,0.054470909800859
"47037018407","Census Tract 184.07, Davidson County, Tennessee",3873,3108,765,0.802478698683191,0.197521301316809
"47037018408","Census Tract 184.08, Davidson County, Tennessee",3438,3053,385,0.888016288539849,0.111983711460151
"47037018409","Census Tract 184.09, Davidson County, Tennessee",3398,3145,253,0.92554443790465,0.0744555620953502
"47037018410","Census Tract 184.10, Davidson County, Tennessee",2846,2470,376,0.867884750527055,0.132115249472945
"47037018500","Census Tract 185, Davidson County, Tennessee",5430,5342,88,0.983793738489871,0.0162062615101289
"47037018601","Census Tract 186.01, Davidson County, Tennessee",2402,2340,62,0.974188176519567,0.025811823480433
"47037018602","Census Tract 186.02, Davidson County, Tennessee",4048,3810,238,0.941205533596838,0.0587944664031621
"47037018700","Census Tract 187, Davidson County, Tennessee",3421,3300,121,0.964630225080386,0.0353697749196141
"47037018801","Census Tract 188.01, Davidson County, Tennessee",5363,5015,348,0.935110945366399,0.0648890546336006
"47037018803","Census Tract 188.03, Davidson County, Tennessee",3192,2828,364,0.885964912280702,0.114035087719298
"47037018804","Census Tract 188.04, Davidson County, Tennessee",5003,4035,968,0.806516090345793,0.193483909654207
"47037018901","Census Tract 189.01, Davidson County, Tennessee",2746,2228,518,0.811361981063365,0.188638018936635
"47037018902","Census Tract 189.02, Davidson County, Tennessee",2510,1912,598,0.761752988047809,0.238247011952191
"47037018904","Census Tract 189.04, Davidson County, Tennessee",4013,2520,1493,0.62795913281834,0.37204086718166
"47037018905","Census Tract 189.05, Davidson County, Tennessee",2802,1800,1002,0.642398286937901,0.357601713062099
"47037019003","Census Tract 190.03, Davidson County, Tennessee",4559,2739,1820,0.60078964685238,0.39921035314762
"47037019004","Census Tract 190.04, Davidson County, Tennessee",4041,2853,1188,0.706013363028953,0.293986636971047
"47037019005","Census Tract 190.05, Davidson County, Tennessee",3139,1647,1492,0.524689391525964,0.475310608474036
"47037019006","Census Tract 190.06, Davidson County, Tennessee",5495,3189,2306,0.580345768880801,0.419654231119199
"47037019105","Census Tract 191.05, Davidson County, Tennessee",4818,3692,1126,0.766293067662931,0.233706932337069
"47037019106","Census Tract 191.06, Davidson County, Tennessee",3531,2862,669,0.81053525913339,0.18946474086661
"47037019108","Census Tract 191.08, Davidson County, Tennessee",2930,1631,1299,0.556655290102389,0.443344709897611
"47037019109","Census Tract 191.09, Davidson County, Tennessee",4373,2600,1773,0.594557512005488,0.405442487994512
"47037019110","Census Tract 191.10, Davidson County, Tennessee",3519,2136,1383,0.606990622335891,0.393009377664109
"47037019111","Census Tract 191.11, Davidson County, Tennessee",4405,2357,2048,0.535073779795687,0.464926220204313
"47037019112","Census Tract 191.12, Davidson County, Tennessee",3749,1938,1811,0.516937850093358,0.483062149906642
"47037019114","Census Tract 191.14, Davidson County, Tennessee",7251,5769,1482,0.795614398014067,0.204385601985933
"47037019115","Census Tract 191.15, Davidson County, Tennessee",3481,2561,920,0.735708129847745,0.264291870152255
"47037019116","Census Tract 191.16, Davidson County, Tennessee",5910,4431,1479,0.749746192893401,0.250253807106599
"47037019117","Census Tract 191.17, Davidson County, Tennessee",3535,1375,2160,0.388967468175389,0.611032531824611
"47037019118","Census Tract 191.18, Davidson County, Tennessee",4360,2548,1812,0.584403669724771,0.415596330275229
"47037019200","Census Tract 192, Davidson County, Tennessee",3223,1825,1398,0.566242631089047,0.433757368910953
"47037019300","Census Tract 193, Davidson County, Tennessee",3064,565,2499,0.184399477806789,0.815600522193211
"47037019400","Census Tract 194, Davidson County, Tennessee",3114,947,2167,0.304110468850353,0.695889531149647
"47037019500","Census Tract 195, Davidson County, Tennessee",4450,2546,1904,0.572134831460674,0.427865168539326
"47037019600","Census Tract 196, Davidson County, Tennessee",3097,2349,748,0.758475944462383,0.241524055537617
"47039955001","Census Tract 9550.01, Decatur County, Tennessee",1724,1622,102,0.940835266821346,0.0591647331786543
"47039955002","Census Tract 9550.02, Decatur County, Tennessee",5063,4677,386,0.923760616235433,0.0762393837645665
"47039955101","Census Tract 9551.01, Decatur County, Tennessee",2021,1881,140,0.930727362691737,0.0692726373082633
"47039955102","Census Tract 9551.02, Decatur County, Tennessee",2908,2834,74,0.97455295735901,0.0254470426409904
"47041920101","Census Tract 9201.01, DeKalb County, Tennessee",2643,2638,5,0.998108210367007,0.00189178963299286
"47041920102","Census Tract 9201.02, DeKalb County, Tennessee",4166,4037,129,0.969035045607297,0.0309649543927029
"47041920200","Census Tract 9202, DeKalb County, Tennessee",6496,5872,624,0.903940886699507,0.0960591133004927
"47041920300","Census Tract 9203, DeKalb County, Tennessee",5264,5060,204,0.961246200607903,0.0387537993920972
"47043060100","Census Tract 601, Dickson County, Tennessee",4738,4590,148,0.968763191219924,0.031236808780076
"47043060200","Census Tract 602, Dickson County, Tennessee",6292,6010,282,0.95518118245391,0.0448188175460903
"47043060300","Census Tract 603, Dickson County, Tennessee",6041,5864,177,0.97070021519616,0.0292997848038404
"47043060401","Census Tract 604.01, Dickson County, Tennessee",2703,2682,21,0.992230854605993,0.00776914539400664
"47043060402","Census Tract 604.02, Dickson County, Tennessee",5602,5292,310,0.944662620492681,0.0553373795073188
"47043060501","Census Tract 605.01, Dickson County, Tennessee",5814,5133,681,0.882868937048504,0.117131062951496
"47043060502","Census Tract 605.02, Dickson County, Tennessee",2870,2632,238,0.917073170731707,0.0829268292682926
"47043060601","Census Tract 606.01, Dickson County, Tennessee",4083,3603,480,0.88243938280676,0.11756061719324
"47043060602","Census Tract 606.02, Dickson County, Tennessee",5926,4845,1081,0.817583530205872,0.182416469794128
"47043060700","Census Tract 607, Dickson County, Tennessee",4643,4389,254,0.945293990954124,0.0547060090458755
"47045964000","Census Tract 9640, Dyer County, Tennessee",6630,6291,339,0.948868778280543,0.0511312217194571
"47045964200","Census Tract 9642, Dyer County, Tennessee",5902,4839,1063,0.819891562182311,0.180108437817689
"47045964300","Census Tract 9643, Dyer County, Tennessee",5453,4120,1333,0.755547405098111,0.244452594901889
"47045964400","Census Tract 9644, Dyer County, Tennessee",6793,3431,3362,0.505078757544531,0.494921242455469
"47045964500","Census Tract 9645, Dyer County, Tennessee",2290,2212,78,0.965938864628821,0.0340611353711791
"47045964600","Census Tract 9646, Dyer County, Tennessee",2551,2502,49,0.980791846334771,0.0192081536652293
"47045964800","Census Tract 9648, Dyer County, Tennessee",3483,3405,78,0.977605512489233,0.0223944875107666
"47045964900","Census Tract 9649, Dyer County, Tennessee",5072,4632,440,0.913249211356467,0.0867507886435331
"47047060300","Census Tract 603, Fayette County, Tennessee",3140,1446,1694,0.460509554140127,0.539490445859873
"47047060401","Census Tract 604.01, Fayette County, Tennessee",2898,2419,479,0.834713595583161,0.165286404416839
"47047060402","Census Tract 604.02, Fayette County, Tennessee",3333,2592,741,0.777677767776778,0.222322232223222
"47047060403","Census Tract 604.03, Fayette County, Tennessee",4174,3106,1068,0.744130330618112,0.255869669381888
"47047060404","Census Tract 604.04, Fayette County, Tennessee",4133,2956,1177,0.715218969271715,0.284781030728285
"47047060501","Census Tract 605.01, Fayette County, Tennessee",4275,2788,1487,0.652163742690059,0.347836257309941
"47047060502","Census Tract 605.02, Fayette County, Tennessee",3877,2849,1028,0.734846530822801,0.265153469177199
"47047060600","Census Tract 606, Fayette County, Tennessee",3719,2341,1378,0.629470287711751,0.370529712288249
"47047060701","Census Tract 607.01, Fayette County, Tennessee",2563,2020,543,0.788138899726883,0.211861100273117
"47047060702","Census Tract 607.02, Fayette County, Tennessee",2398,1609,789,0.670975813177648,0.329024186822352
"47047060800","Census Tract 608, Fayette County, Tennessee",2948,1947,1001,0.66044776119403,0.33955223880597
"47049965000","Census Tract 9650, Fentress County, Tennessee",3303,3225,78,0.9763851044505,0.0236148955495005
"47049965100","Census Tract 9651, Fentress County, Tennessee",4365,4305,60,0.986254295532646,0.0137457044673539
"47049965200","Census Tract 9652, Fentress County, Tennessee",5698,5647,51,0.991049491049491,0.00895050895050897
"47049965300","Census Tract 9653, Fentress County, Tennessee",4411,4343,68,0.984583994559057,0.0154160054409431
"47051960100","Census Tract 9601, Franklin County, Tennessee",3660,3406,254,0.930601092896175,0.0693989071038251
"47051960201","Census Tract 9602.01, Franklin County, Tennessee",5832,5553,279,0.952160493827161,0.0478395061728395
"47051960202","Census Tract 9602.02, Franklin County, Tennessee",5333,5065,268,0.949746859178699,0.0502531408213013
"47051960300","Census Tract 9603, Franklin County, Tennessee",3105,2898,207,0.933333333333333,0.0666666666666667
"47051960400","Census Tract 9604, Franklin County, Tennessee",7255,6363,892,0.877050310130944,0.122949689869056
"47051960500","Census Tract 9605, Franklin County, Tennessee",3851,3137,714,0.814593612048819,0.185406387951181
"47051960600","Census Tract 9606, Franklin County, Tennessee",4955,4445,510,0.8970736629667,0.1029263370333
"47051960700","Census Tract 9607, Franklin County, Tennessee",3900,3703,197,0.94948717948718,0.0505128205128205
"47051960800","Census Tract 9608, Franklin County, Tennessee",3163,2610,553,0.825165981662978,0.174834018337022
"47053966100","Census Tract 9661, Gibson County, Tennessee",2557,2078,479,0.812671098944075,0.187328901055925
"47053966200","Census Tract 9662, Gibson County, Tennessee",3693,3114,579,0.843216896831844,0.156783103168156
"47053966300","Census Tract 9663, Gibson County, Tennessee",2570,2102,468,0.817898832684825,0.182101167315175
"47053966400","Census Tract 9664, Gibson County, Tennessee",5768,4846,922,0.840152565880721,0.159847434119279
"47053966500","Census Tract 9665, Gibson County, Tennessee",4708,3428,1280,0.728122344944775,0.271877655055225
"47053966600","Census Tract 9666, Gibson County, Tennessee",1861,1696,165,0.911337990327781,0.0886620096722193
"47053966700","Census Tract 9667, Gibson County, Tennessee",6056,4367,1689,0.721103038309115,0.278896961690885
"47053966800","Census Tract 9668, Gibson County, Tennessee",1282,1218,64,0.950078003120125,0.0499219968798752
"47053966900","Census Tract 9669, Gibson County, Tennessee",3228,794,2434,0.245972738537794,0.754027261462206
"47053967000","Census Tract 9670, Gibson County, Tennessee",7429,5471,1958,0.736438282406784,0.263561717593216
"47053967100","Census Tract 9671, Gibson County, Tennessee",4985,4807,178,0.964292878635908,0.0357071213640923
"47053967300","Census Tract 9673, Gibson County, Tennessee",1142,1061,81,0.92907180385289,0.0709281961471103
"47053967400","Census Tract 9674, Gibson County, Tennessee",3736,3666,70,0.981263383297645,0.0187366167023555
"47055920100","Census Tract 9201, Giles County, Tennessee",3423,3095,328,0.904177621969033,0.0958223780309669
"47055920200","Census Tract 9202, Giles County, Tennessee",4100,3411,689,0.831951219512195,0.168048780487805
"47055920300","Census Tract 9203, Giles County, Tennessee",6037,4938,1099,0.81795593837999,0.18204406162001
"47055920400","Census Tract 9204, Giles County, Tennessee",3431,2996,435,0.873214806178957,0.126785193821043
"47055920500","Census Tract 9205, Giles County, Tennessee",4947,4230,717,0.855063674954518,0.144936325045482
"47055920600","Census Tract 9206, Giles County, Tennessee",2971,2877,94,0.968360821272299,0.0316391787277011
"47055920700","Census Tract 9207, Giles County, Tennessee",1619,1474,145,0.910438542310068,0.0895614576899321
"47055920800","Census Tract 9208, Giles County, Tennessee",3030,2635,395,0.86963696369637,0.13036303630363
"47057500100","Census Tract 5001, Grainger County, Tennessee",3667,3617,50,0.986364875920371,0.0136351240796291
"47057500200","Census Tract 5002, Grainger County, Tennessee",4964,4880,84,0.983078162771958,0.0169218372280419
"47057500300","Census Tract 5003, Grainger County, Tennessee",6383,6089,294,0.953940153532822,0.0460598464671784
"47057500401","Census Tract 5004.01, Grainger County, Tennessee",2560,2560,0,1,0
"47057500402","Census Tract 5004.02, Grainger County, Tennessee",4845,4740,105,0.978328173374613,0.021671826625387
"47059090100","Census Tract 901, Greene County, Tennessee",6732,6049,683,0.898544266191325,0.101455733808675
"47059090200","Census Tract 902, Greene County, Tennessee",2569,2388,181,0.929544569871545,0.0704554301284547
"47059090300","Census Tract 903, Greene County, Tennessee",5565,4972,593,0.893441150044924,0.106558849955076
"47059090400","Census Tract 904, Greene County, Tennessee",5660,5306,354,0.937455830388693,0.0625441696113074
"47059090500","Census Tract 905, Greene County, Tennessee",6754,6619,135,0.980011844832692,0.0199881551673082
"47059090600","Census Tract 906, Greene County, Tennessee",3445,3412,33,0.990420899854862,0.00957910014513785
"47059090700","Census Tract 907, Greene County, Tennessee",2523,2495,28,0.988902100673801,0.011097899326199
"47059090800","Census Tract 908, Greene County, Tennessee",4697,4525,172,0.963380881413668,0.0366191185863317
"47059090900","Census Tract 909, Greene County, Tennessee",5435,5265,170,0.968721251149954,0.031278748850046
"47059091000","Census Tract 910, Greene County, Tennessee",7339,7124,215,0.970704455647908,0.0292955443520916
"47059091100","Census Tract 911, Greene County, Tennessee",3493,3461,32,0.990838820498139,0.00916117950186091
"47059091200","Census Tract 912, Greene County, Tennessee",3601,3573,28,0.992224382116079,0.00777561788392112
"47059091300","Census Tract 913, Greene County, Tennessee",4576,4551,25,0.994536713286713,0.00546328671328666
"47059091400","Census Tract 914, Greene County, Tennessee",2715,2577,138,0.949171270718232,0.050828729281768
"47059091500","Census Tract 915, Greene County, Tennessee",3068,3002,66,0.978487614080834,0.0215123859191656
"47061955000","Census Tract 9550, Grundy County, Tennessee",2869,2365,504,0.824329034506797,0.175670965493203
"47061955100","Census Tract 9551, Grundy County, Tennessee",1867,1762,105,0.943760042849491,0.0562399571505089
"47061955200","Census Tract 9552, Grundy County, Tennessee",3681,3213,468,0.872860635696821,0.127139364303179
"47061955300","Census Tract 9553, Grundy County, Tennessee",5493,4694,799,0.854542144547606,0.145457855452394
"47063100100","Census Tract 1001, Hamblen County, Tennessee",6637,5588,1049,0.841946662648787,0.158053337351213
"47063100200","Census Tract 1002, Hamblen County, Tennessee",5614,4728,886,0.842180263626648,0.157819736373352
"47063100300","Census Tract 1003, Hamblen County, Tennessee",3252,2873,379,0.883456334563346,0.116543665436654
"47063100400","Census Tract 1004, Hamblen County, Tennessee",6044,4778,1266,0.79053606882859,0.20946393117141
"47063100500","Census Tract 1005, Hamblen County, Tennessee",3145,2943,202,0.93577106518283,0.0642289348171701
"47063100600","Census Tract 1006, Hamblen County, Tennessee",7516,7405,111,0.985231506120277,0.0147684938797232
"47063100700","Census Tract 1007, Hamblen County, Tennessee",5607,5391,216,0.961476725521669,0.0385232744783307
"47063100800","Census Tract 1008, Hamblen County, Tennessee",3661,3383,278,0.924064463261404,0.075935536738596
"47063100900","Census Tract 1009, Hamblen County, Tennessee",4646,4419,227,0.951140766250538,0.0488592337494619
"47063101000","Census Tract 1010, Hamblen County, Tennessee",4814,4680,134,0.972164520149564,0.0278354798504362
"47063101100","Census Tract 1011, Hamblen County, Tennessee",4820,4805,15,0.996887966804979,0.00311203319502074
"47063101200","Census Tract 1012, Hamblen County, Tennessee",6101,5896,205,0.966398950991641,0.0336010490083593
"47065000400","Census Tract 4, Hamilton County, Tennessee",3351,206,3145,0.0614741868099075,0.938525813190093
"47065000600","Census Tract 6, Hamilton County, Tennessee",2862,2415,447,0.843815513626834,0.156184486373166
"47065000700","Census Tract 7, Hamilton County, Tennessee",3924,3693,231,0.941131498470948,0.058868501529052
"47065000800","Census Tract 8, Hamilton County, Tennessee",1768,1318,450,0.745475113122172,0.254524886877828
"47065001100","Census Tract 11, Hamilton County, Tennessee",1707,401,1306,0.234915055653193,0.765084944346807
"47065001200","Census Tract 12, Hamilton County, Tennessee",3296,253,3043,0.0767597087378641,0.923240291262136
"47065001300","Census Tract 13, Hamilton County, Tennessee",1821,678,1143,0.372322899505766,0.627677100494234
"47065001400","Census Tract 14, Hamilton County, Tennessee",1507,625,882,0.414731254147313,0.585268745852688
"47065001600","Census Tract 16, Hamilton County, Tennessee",2184,455,1729,0.208333333333333,0.791666666666667
"47065001800","Census Tract 18, Hamilton County, Tennessee",3211,2129,1082,0.663033322952351,0.336966677047649
"47065001900","Census Tract 19, Hamilton County, Tennessee",4417,231,4186,0.05229793977813,0.94770206022187
"47065002000","Census Tract 20, Hamilton County, Tennessee",1033,174,859,0.168441432720232,0.831558567279768
"47065002300","Census Tract 23, Hamilton County, Tennessee",1147,705,442,0.614646904969486,0.385353095030514
"47065002400","Census Tract 24, Hamilton County, Tennessee",4088,2908,1180,0.711350293542074,0.288649706457926
"47065002500","Census Tract 25, Hamilton County, Tennessee",4626,1701,2925,0.367704280155642,0.632295719844358
"47065002600","Census Tract 26, Hamilton County, Tennessee",2126,889,1237,0.418156161806209,0.581843838193791
"47065002800","Census Tract 28, Hamilton County, Tennessee",3918,2794,1124,0.713118938233793,0.286881061766207
"47065002900","Census Tract 29, Hamilton County, Tennessee",2359,1129,1230,0.478592623993217,0.521407376006783
"47065003000","Census Tract 30, Hamilton County, Tennessee",2575,1084,1491,0.420970873786408,0.579029126213592
"47065003100","Census Tract 31, Hamilton County, Tennessee",1716,1114,602,0.649184149184149,0.350815850815851
"47065003200","Census Tract 32, Hamilton County, Tennessee",3259,329,2930,0.10095121202823,0.89904878797177
"47065003300","Census Tract 33, Hamilton County, Tennessee",7109,1057,6052,0.148684765789844,0.851315234210156
"47065003400","Census Tract 34, Hamilton County, Tennessee",4409,2935,1474,0.665683828532547,0.334316171467453
"47065010101","Census Tract 101.01, Hamilton County, Tennessee",6032,5712,320,0.946949602122016,0.053050397877984
"47065010103","Census Tract 101.03, Hamilton County, Tennessee",3509,3287,222,0.936734112282702,0.0632658877172984
"47065010104","Census Tract 101.04, Hamilton County, Tennessee",3860,3828,32,0.991709844559585,0.00829015544041456
"47065010201","Census Tract 102.01, Hamilton County, Tennessee",2876,2876,0,1,0
"47065010202","Census Tract 102.02, Hamilton County, Tennessee",3929,3829,100,0.974548231102062,0.0254517688979384
"47065010303","Census Tract 103.03, Hamilton County, Tennessee",2905,2843,62,0.978657487091222,0.021342512908778
"47065010304","Census Tract 103.04, Hamilton County, Tennessee",5270,5139,131,0.975142314990512,0.0248576850094877
"47065010305","Census Tract 103.05, Hamilton County, Tennessee",3079,3001,78,0.974667099707697,0.0253329002923027
"47065010306","Census Tract 103.06, Hamilton County, Tennessee",3898,3789,109,0.97203694202155,0.0279630579784504
"47065010307","Census Tract 103.07, Hamilton County, Tennessee",4977,4880,97,0.980510347598955,0.0194896524010448
"47065010411","Census Tract 104.11, Hamilton County, Tennessee",6182,5645,537,0.913134907796829,0.0868650922031705
"47065010412","Census Tract 104.12, Hamilton County, Tennessee",5590,5418,172,0.969230769230769,0.0307692307692308
"47065010413","Census Tract 104.13, Hamilton County, Tennessee",4213,4002,211,0.949916923807263,0.0500830761927368
"47065010431","Census Tract 104.31, Hamilton County, Tennessee",6652,5866,786,0.881840048105833,0.118159951894167
"47065010432","Census Tract 104.32, Hamilton County, Tennessee",6540,6266,274,0.958103975535168,0.0418960244648318
"47065010433","Census Tract 104.33, Hamilton County, Tennessee",5059,4543,516,0.898003558015418,0.101996441984582
"47065010434","Census Tract 104.34, Hamilton County, Tennessee",1774,1705,69,0.961104847801578,0.0388951521984217
"47065010435","Census Tract 104.35, Hamilton County, Tennessee",5858,5507,351,0.940081939228406,0.0599180607715945
"47065010501","Census Tract 105.01, Hamilton County, Tennessee",6370,5781,589,0.907535321821036,0.0924646781789639
"47065010502","Census Tract 105.02, Hamilton County, Tennessee",3241,2732,509,0.842949706880592,0.157050293119408
"47065010600","Census Tract 106, Hamilton County, Tennessee",2628,2503,125,0.952435312024353,0.0475646879756468
"47065010700","Census Tract 107, Hamilton County, Tennessee",2714,2267,447,0.835298452468681,0.164701547531319
"47065010800","Census Tract 108, Hamilton County, Tennessee",4084,3464,620,0.84818805093046,0.15181194906954
"47065010901","Census Tract 109.01, Hamilton County, Tennessee",1818,1513,305,0.832233223322332,0.167766776677668
"47065010902","Census Tract 109.02, Hamilton County, Tennessee",638,638,0,1,0
"47065010903","Census Tract 109.03, Hamilton County, Tennessee",5874,5021,853,0.85478379298604,0.14521620701396
"47065011001","Census Tract 110.01, Hamilton County, Tennessee",1666,1666,0,1,0
"47065011002","Census Tract 110.02, Hamilton County, Tennessee",6529,6375,154,0.976412926941339,0.0235870730586614
"47065011100","Census Tract 111, Hamilton County, Tennessee",6731,6633,98,0.985440499182885,0.0145595008171149
"47065011201","Census Tract 112.01, Hamilton County, Tennessee",6871,6221,650,0.905399505166642,0.0946004948333576
"47065011203","Census Tract 112.03, Hamilton County, Tennessee",6253,5067,1186,0.810331041100272,0.189668958899728
"47065011204","Census Tract 112.04, Hamilton County, Tennessee",5311,4919,392,0.926190924496328,0.0738090755036717
"47065011311","Census Tract 113.11, Hamilton County, Tennessee",6058,4603,1455,0.759821723341037,0.240178276658963
"47065011314","Census Tract 113.14, Hamilton County, Tennessee",4746,4093,653,0.862410450906026,0.137589549093974
"47065011321","Census Tract 113.21, Hamilton County, Tennessee",6432,4886,1546,0.759639303482587,0.240360696517413
"47065011323","Census Tract 113.23, Hamilton County, Tennessee",6046,5023,1023,0.830797221303341,0.169202778696659
"47065011324","Census Tract 113.24, Hamilton County, Tennessee",4070,3350,720,0.823095823095823,0.176904176904177
"47065011325","Census Tract 113.25, Hamilton County, Tennessee",5343,4049,1294,0.757813962193524,0.242186037806476
"47065011326","Census Tract 113.26, Hamilton County, Tennessee",4693,3811,882,0.812060515661624,0.187939484338376
"47065011402","Census Tract 114.02, Hamilton County, Tennessee",6448,1417,5031,0.219758064516129,0.780241935483871
"47065011411","Census Tract 114.11, Hamilton County, Tennessee",3126,1913,1213,0.611964171465131,0.388035828534869
"47065011413","Census Tract 114.13, Hamilton County, Tennessee",8018,6150,1868,0.76702419555999,0.23297580444001
"47065011442","Census Tract 114.42, Hamilton County, Tennessee",2833,2163,670,0.763501588422167,0.236498411577833
"47065011443","Census Tract 114.43, Hamilton County, Tennessee",5594,4353,1241,0.778155166249553,0.221844833750447
"47065011444","Census Tract 114.44, Hamilton County, Tennessee",3627,503,3124,0.138682106424042,0.861317893575958
"47065011445","Census Tract 114.45, Hamilton County, Tennessee",3638,2410,1228,0.662451896646509,0.337548103353491
"47065011446","Census Tract 114.46, Hamilton County, Tennessee",3325,2719,606,0.817744360902256,0.182255639097744
"47065011447","Census Tract 114.47, Hamilton County, Tennessee",7132,6413,719,0.899186763881099,0.100813236118901
"47065011600","Census Tract 116, Hamilton County, Tennessee",5644,4566,1078,0.809000708717222,0.190999291282778
"47065011700","Census Tract 117, Hamilton County, Tennessee",3736,3307,429,0.88517130620985,0.11482869379015
"47065011800","Census Tract 118, Hamilton County, Tennessee",6559,5912,647,0.901356914163745,0.0986430858362555
"47065011900","Census Tract 119, Hamilton County, Tennessee",1678,1165,513,0.694278903456496,0.305721096543504
"47065012000","Census Tract 120, Hamilton County, Tennessee",1894,1814,80,0.957761351636748,0.0422386483632524
"47065012100","Census Tract 121, Hamilton County, Tennessee",5683,5510,173,0.969558331866972,0.0304416681330283
"47065012200","Census Tract 122, Hamilton County, Tennessee",2899,139,2760,0.0479475681269403,0.95205243187306
"47065012300","Census Tract 123, Hamilton County, Tennessee",4780,1524,3256,0.318828451882845,0.681171548117155
"47065012400","Census Tract 124, Hamilton County, Tennessee",3411,2175,1236,0.63764291996482,0.36235708003518
"47065980200","Census Tract 9802, Hamilton County, Tennessee",203,174,29,0.857142857142857,0.142857142857143
"47067960500","Census Tract 9605, Hancock County, Tennessee",2396,2369,27,0.98873121869783,0.0112687813021702
"47067960600","Census Tract 9606, Hancock County, Tennessee",4386,4282,104,0.976288189694482,0.0237118103055176
"47069950100","Census Tract 9501, Hardeman County, Tennessee",3851,3213,638,0.834328745780317,0.165671254219683
"47069950200","Census Tract 9502, Hardeman County, Tennessee",6216,2367,3849,0.380791505791506,0.619208494208494
"47069950300","Census Tract 9503, Hardeman County, Tennessee",4030,1744,2286,0.432754342431762,0.567245657568238
"47069950400","Census Tract 9504, Hardeman County, Tennessee",5952,2951,3001,0.495799731182796,0.504200268817204
"47069950500","Census Tract 9505, Hardeman County, Tennessee",4636,4091,545,0.88244176013805,0.11755823986195
"47069950600","Census Tract 9506, Hardeman County, Tennessee",2970,1287,1683,0.433333333333333,0.566666666666667
"47071920100","Census Tract 9201, Hardin County, Tennessee",3679,3533,146,0.960315303071487,0.0396846969285132
"47071920200","Census Tract 9202, Hardin County, Tennessee",5089,4846,243,0.952249950874435,0.0477500491255649
"47071920300","Census Tract 9203, Hardin County, Tennessee",3917,3360,557,0.857799336226704,0.142200663773296
"47071920400","Census Tract 9204, Hardin County, Tennessee",4868,4592,276,0.943303204601479,0.0566967953985209
"47071920500","Census Tract 9205, Hardin County, Tennessee",5450,5376,74,0.986422018348624,0.0135779816513761
"47071920600","Census Tract 9206, Hardin County, Tennessee",2992,2822,170,0.943181818181818,0.0568181818181818
"47073050100","Census Tract 501, Hawkins County, Tennessee",4089,4064,25,0.993886035705551,0.00611396429444855
"47073050200","Census Tract 502, Hawkins County, Tennessee",5062,5003,59,0.988344527854603,0.0116554721453971
"47073050301","Census Tract 503.01, Hawkins County, Tennessee",4336,4012,324,0.925276752767528,0.0747232472324724
"47073050302","Census Tract 503.02, Hawkins County, Tennessee",3934,3760,174,0.955770208439248,0.0442297915607525
"47073050400","Census Tract 504, Hawkins County, Tennessee",5954,5701,253,0.957507557944239,0.0424924420557609
"47073050501","Census Tract 505.01, Hawkins County, Tennessee",3925,3869,56,0.985732484076433,0.0142675159235669
"47073050502","Census Tract 505.02, Hawkins County, Tennessee",3323,3206,117,0.964790851640084,0.0352091483599157
"47073050503","Census Tract 505.03, Hawkins County, Tennessee",4129,4051,78,0.981109227415839,0.0188907725841608
"47073050601","Census Tract 506.01, Hawkins County, Tennessee",6447,6112,335,0.948037847060648,0.0519621529393517
"47073050602","Census Tract 506.02, Hawkins County, Tennessee",4412,4304,108,0.975521305530372,0.0244786944696282
"47073050700","Census Tract 507, Hawkins County, Tennessee",3006,2968,38,0.987358616101131,0.0126413838988689
"47073050800","Census Tract 508, Hawkins County, Tennessee",4969,4696,273,0.945059368082109,0.0549406319178909
"47073050900","Census Tract 509, Hawkins County, Tennessee",2976,2937,39,0.986895161290323,0.0131048387096774
"47075930100","Census Tract 9301, Haywood County, Tennessee",3122,2554,568,0.81806534272902,0.18193465727098
"47075930200","Census Tract 9302, Haywood County, Tennessee",1527,885,642,0.579567779960707,0.420432220039293
"47075930301","Census Tract 9303.01, Haywood County, Tennessee",4234,1379,2855,0.32569674067076,0.67430325932924
"47075930302","Census Tract 9303.02, Haywood County, Tennessee",2918,713,2205,0.244345442083619,0.755654557916381
"47075930400","Census Tract 9304, Haywood County, Tennessee",4544,2067,2477,0.454885563380282,0.545114436619718
"47075930500","Census Tract 9305, Haywood County, Tennessee",2665,1247,1418,0.467917448405253,0.532082551594747
"47077975000","Census Tract 9750, Henderson County, Tennessee",2744,2615,129,0.95298833819242,0.0470116618075802
"47077975100","Census Tract 9751, Henderson County, Tennessee",3572,3031,541,0.848544232922732,0.151455767077268
"47077975200","Census Tract 9752, Henderson County, Tennessee",6031,5751,280,0.953573205106947,0.0464267948930526
"47077975300","Census Tract 9753, Henderson County, Tennessee",6778,6034,744,0.890233107111242,0.109766892888758
"47077975400","Census Tract 9754, Henderson County, Tennessee",4914,3760,1154,0.765160765160765,0.234839234839235
"47077975500","Census Tract 9755, Henderson County, Tennessee",3479,3380,99,0.971543546996263,0.0284564530037367
"47079969000","Census Tract 9690, Henry County, Tennessee",4295,4250,45,0.989522700814901,0.010477299185099
"47079969100","Census Tract 9691, Henry County, Tennessee",2852,2756,96,0.966339410939691,0.0336605890603086
"47079969200","Census Tract 9692, Henry County, Tennessee",1985,1918,67,0.96624685138539,0.0337531486146095
"47079969300","Census Tract 9693, Henry County, Tennessee",3611,2487,1124,0.68872888396566,0.31127111603434
"47079969400","Census Tract 9694, Henry County, Tennessee",2348,1600,748,0.681431005110733,0.318568994889267
"47079969500","Census Tract 9695, Henry County, Tennessee",4885,4394,491,0.899488229273286,0.100511770726714
"47079969600","Census Tract 9696, Henry County, Tennessee",7351,6918,433,0.941096449462658,0.0589035505373419
"47079969700","Census Tract 9697, Henry County, Tennessee",2345,2172,173,0.926226012793177,0.073773987206823
"47079969800","Census Tract 9698, Henry County, Tennessee",2370,2213,157,0.933755274261603,0.0662447257383966
"47081950100","Census Tract 9501, Hickman County, Tennessee",4941,4752,189,0.961748633879781,0.0382513661202186
"47081950200","Census Tract 9502, Hickman County, Tennessee",7337,7067,270,0.963200218072782,0.0367997819272182
"47081950301","Census Tract 9503.01, Hickman County, Tennessee",3291,3087,204,0.938012762078396,0.0619872379216043
"47081950302","Census Tract 9503.02, Hickman County, Tennessee",4417,4129,288,0.934797373783111,0.0652026262168893
"47081950400","Census Tract 9504, Hickman County, Tennessee",2180,2180,0,1,0
"47081950500","Census Tract 9505, Hickman County, Tennessee",2340,1496,844,0.639316239316239,0.360683760683761
"47083120100","Census Tract 1201, Houston County, Tennessee",3030,3030,0,1,0
"47083120200","Census Tract 1202, Houston County, Tennessee",2358,2137,221,0.906276505513147,0.0937234944868532
"47083120300","Census Tract 1203, Houston County, Tennessee",2898,2758,140,0.951690821256039,0.0483091787439613
"47085130100","Census Tract 1301, Humphreys County, Tennessee",5180,5059,121,0.976640926640927,0.0233590733590734
"47085130200","Census Tract 1302, Humphreys County, Tennessee",2024,2000,24,0.988142292490119,0.0118577075098815
"47085130300","Census Tract 1303, Humphreys County, Tennessee",6040,5626,414,0.931456953642384,0.0685430463576159
"47085130400","Census Tract 1304, Humphreys County, Tennessee",2355,2283,72,0.969426751592357,0.0305732484076433
"47085130500","Census Tract 1305, Humphreys County, Tennessee",2817,2616,201,0.928647497337593,0.0713525026624068
"47087960100","Census Tract 9601, Jackson County, Tennessee",1774,1774,0,1,0
"47087960200","Census Tract 9602, Jackson County, Tennessee",2115,2051,64,0.969739952718676,0.0302600472813239
"47087960300","Census Tract 9603, Jackson County, Tennessee",5463,5297,166,0.969613765330405,0.0303862346695954
"47087960400","Census Tract 9604, Jackson County, Tennessee",2139,2139,0,1,0
"47089070100","Census Tract 701, Jefferson County, Tennessee",6859,6633,226,0.967050590465082,0.0329494095349177
"47089070200","Census Tract 702, Jefferson County, Tennessee",5208,4999,209,0.959869431643625,0.0401305683563749
"47089070300","Census Tract 703, Jefferson County, Tennessee",7397,6661,736,0.900500202784913,0.0994997972150872
"47089070400","Census Tract 704, Jefferson County, Tennessee",3616,3459,157,0.95658185840708,0.0434181415929203
"47089070500","Census Tract 705, Jefferson County, Tennessee",4897,4841,56,0.988564427200327,0.0114355727996732
"47089070600","Census Tract 706, Jefferson County, Tennessee",4951,4673,278,0.943849727327813,0.0561502726721874
"47089070700","Census Tract 707, Jefferson County, Tennessee",6751,6478,273,0.959561546437565,0.0404384535624351
"47089070800","Census Tract 708, Jefferson County, Tennessee",6779,6578,201,0.970349609086886,0.0296503909131141
"47089070900","Census Tract 709, Jefferson County, Tennessee",4142,4050,92,0.977788507967166,0.0222114920328343
"47091956000","Census Tract 9560, Johnson County, Tennessee",962,913,49,0.949064449064449,0.0509355509355509
"47091956100","Census Tract 9561, Johnson County, Tennessee",4530,4145,385,0.915011037527594,0.0849889624724062
"47091956200","Census Tract 9562, Johnson County, Tennessee",2286,2236,50,0.978127734033246,0.0218722659667542
"47091956300","Census Tract 9563, Johnson County, Tennessee",5990,5762,228,0.961936560934891,0.0380634390651086
"47091956400","Census Tract 9564, Johnson County, Tennessee",4422,4419,3,0.99932157394844,0.000678426051560432
"47093000100","Census Tract 1, Knox County, Tennessee",1606,1350,256,0.840597758405978,0.159402241594022
"47093000800","Census Tract 8, Knox County, Tennessee",3517,2901,616,0.824850725049758,0.175149274950242
"47093000901","Census Tract 9.01, Knox County, Tennessee",3099,2538,561,0.818973862536302,0.181026137463698
"47093000902","Census Tract 9.02, Knox County, Tennessee",5382,4780,602,0.888145670754366,0.111854329245634
"47093001400","Census Tract 14, Knox County, Tennessee",3126,2080,1046,0.665387076135637,0.334612923864363
"47093001500","Census Tract 15, Knox County, Tennessee",3319,2850,469,0.858692377222055,0.141307622777945
"47093001600","Census Tract 16, Knox County, Tennessee",2796,2378,418,0.850500715307582,0.149499284692418
"47093001700","Census Tract 17, Knox County, Tennessee",2145,2017,128,0.94032634032634,0.0596736596736597
"47093001800","Census Tract 18, Knox County, Tennessee",2307,1869,438,0.810143042912874,0.189856957087126
"47093001900","Census Tract 19, Knox County, Tennessee",1285,490,795,0.381322957198444,0.618677042801556
"47093002000","Census Tract 20, Knox County, Tennessee",3559,861,2698,0.241921888170835,0.758078111829166
"47093002100","Census Tract 21, Knox County, Tennessee",2784,1038,1746,0.372844827586207,0.627155172413793
"47093002200","Census Tract 22, Knox County, Tennessee",3968,3751,217,0.9453125,0.0546875
"47093002300","Census Tract 23, Knox County, Tennessee",2935,2483,452,0.845996592844974,0.154003407155026
"47093002400","Census Tract 24, Knox County, Tennessee",3982,3593,389,0.902310396785535,0.0976896032144651
"47093002600","Census Tract 26, Knox County, Tennessee",2268,1556,712,0.686067019400353,0.313932980599647
"47093002700","Census Tract 27, Knox County, Tennessee",2735,2230,505,0.815356489945155,0.184643510054845
"47093002800","Census Tract 28, Knox County, Tennessee",4486,2235,2251,0.498216674097191,0.501783325902809
"47093002900","Census Tract 29, Knox County, Tennessee",3380,2303,1077,0.681360946745562,0.318639053254438
"47093003000","Census Tract 30, Knox County, Tennessee",5054,3967,1087,0.784922833399288,0.215077166600712
"47093003100","Census Tract 31, Knox County, Tennessee",2730,2356,374,0.863003663003663,0.136996336996337
"47093003200","Census Tract 32, Knox County, Tennessee",3441,1446,1995,0.420226678291194,0.579773321708806
"47093003300","Census Tract 33, Knox County, Tennessee",2180,1566,614,0.718348623853211,0.281651376146789
"47093003400","Census Tract 34, Knox County, Tennessee",3688,3312,376,0.898047722342733,0.101952277657267
"47093003500","Census Tract 35, Knox County, Tennessee",3773,3255,518,0.862708719851577,0.137291280148423
"47093003700","Census Tract 37, Knox County, Tennessee",3721,2915,806,0.783391561408224,0.216608438591776
"47093003801","Census Tract 38.01, Knox County, Tennessee",4506,4003,503,0.888371060807812,0.111628939192188
"47093003802","Census Tract 38.02, Knox County, Tennessee",3062,2594,468,0.847158719790986,0.152841280209014
"47093003901","Census Tract 39.01, Knox County, Tennessee",4034,3123,911,0.77416955875062,0.22583044124938
"47093003902","Census Tract 39.02, Knox County, Tennessee",3171,2623,548,0.82718385367392,0.17281614632608
"47093004000","Census Tract 40, Knox County, Tennessee",3834,3570,264,0.931142410015649,0.0688575899843505
"47093004100","Census Tract 41, Knox County, Tennessee",4143,3690,453,0.890658942795076,0.109341057204924
"47093004200","Census Tract 42, Knox County, Tennessee",3488,3351,137,0.96072247706422,0.0392775229357798
"47093004300","Census Tract 43, Knox County, Tennessee",2525,2174,351,0.860990099009901,0.139009900990099
"47093004401","Census Tract 44.01, Knox County, Tennessee",4276,4113,163,0.961880261927035,0.0381197380729654
"47093004403","Census Tract 44.03, Knox County, Tennessee",4497,3879,618,0.862575050033356,0.137424949966644
"47093004404","Census Tract 44.04, Knox County, Tennessee",3500,2983,517,0.852285714285714,0.147714285714286
"47093004500","Census Tract 45, Knox County, Tennessee",5549,4608,941,0.830419895476663,0.169580104523337
"47093004606","Census Tract 46.06, Knox County, Tennessee",6298,5842,456,0.927596062241982,0.0724039377580185
"47093004607","Census Tract 46.07, Knox County, Tennessee",5602,4878,724,0.870760442699036,0.129239557300964
"47093004608","Census Tract 46.08, Knox County, Tennessee",2911,2311,600,0.79388526279629,0.20611473720371
"47093004609","Census Tract 46.09, Knox County, Tennessee",4896,4464,432,0.911764705882353,0.0882352941176471
"47093004610","Census Tract 46.10, Knox County, Tennessee",4958,4046,912,0.81605486083098,0.18394513916902
"47093004611","Census Tract 46.11, Knox County, Tennessee",3949,3586,363,0.908077994428969,0.0919220055710307
"47093004612","Census Tract 46.12, Knox County, Tennessee",2353,1755,598,0.74585635359116,0.25414364640884
"47093004613","Census Tract 46.13, Knox County, Tennessee",4984,4472,512,0.897271268057785,0.102728731942215
"47093004614","Census Tract 46.14, Knox County, Tennessee",2926,2612,314,0.892686261107314,0.107313738892686
"47093004615","Census Tract 46.15, Knox County, Tennessee",4410,3848,562,0.872562358276644,0.127437641723356
"47093004700","Census Tract 47, Knox County, Tennessee",3630,3259,371,0.897796143250689,0.102203856749311
"47093004800","Census Tract 48, Knox County, Tennessee",5239,4647,592,0.88700133613285,0.11299866386715
"47093004900","Census Tract 49, Knox County, Tennessee",5120,4879,241,0.9529296875,0.0470703125
"47093005000","Census Tract 50, Knox County, Tennessee",3997,3708,289,0.927695771828872,0.0723042281711284
"47093005100","Census Tract 51, Knox County, Tennessee",5513,5176,337,0.938871757663704,0.061128242336296
"47093005201","Census Tract 52.01, Knox County, Tennessee",5410,4632,778,0.856192236598891,0.143807763401109
"47093005202","Census Tract 52.02, Knox County, Tennessee",3314,2673,641,0.806578153289077,0.193421846710923
"47093005301","Census Tract 53.01, Knox County, Tennessee",3757,3581,176,0.953154112323663,0.0468458876763375
"47093005302","Census Tract 53.02, Knox County, Tennessee",3692,3663,29,0.992145178764897,0.00785482123510295
"47093005401","Census Tract 54.01, Knox County, Tennessee",3624,3442,182,0.949779249448124,0.0502207505518764
"47093005402","Census Tract 54.02, Knox County, Tennessee",2893,2893,0,1,0
"47093005501","Census Tract 55.01, Knox County, Tennessee",2741,2685,56,0.979569500182415,0.0204304998175848
"47093005502","Census Tract 55.02, Knox County, Tennessee",3816,3510,306,0.919811320754717,0.0801886792452831
"47093005602","Census Tract 56.02, Knox County, Tennessee",4568,4398,170,0.962784588441331,0.037215411558669
"47093005603","Census Tract 56.03, Knox County, Tennessee",3480,3245,235,0.932471264367816,0.0675287356321839
"47093005604","Census Tract 56.04, Knox County, Tennessee",2636,2440,196,0.925644916540212,0.0743550834597876
"47093005701","Census Tract 57.01, Knox County, Tennessee",4153,3969,184,0.95569467854563,0.0443053214543704
"47093005704","Census Tract 57.04, Knox County, Tennessee",5398,4840,558,0.896628380881808,0.103371619118192
"47093005706","Census Tract 57.06, Knox County, Tennessee",3501,3136,365,0.895744073121965,0.104255926878035
"47093005707","Census Tract 57.07, Knox County, Tennessee",3121,2683,438,0.859660365267542,0.140339634732458
"47093005708","Census Tract 57.08, Knox County, Tennessee",3432,2788,644,0.812354312354312,0.187645687645688
"47093005709","Census Tract 57.09, Knox County, Tennessee",2106,1942,164,0.922127255460589,0.0778727445394112
"47093005710","Census Tract 57.10, Knox County, Tennessee",2318,2247,71,0.969370146678171,0.0306298533218292
"47093005711","Census Tract 57.11, Knox County, Tennessee",5728,5421,307,0.946403631284916,0.0535963687150838
"47093005712","Census Tract 57.12, Knox County, Tennessee",8141,7348,793,0.902591819186832,0.0974081808131679
"47093005803","Census Tract 58.03, Knox County, Tennessee",2453,2429,24,0.990216061964941,0.00978393803505906
"47093005807","Census Tract 58.07, Knox County, Tennessee",2681,2348,333,0.875792614696009,0.124207385303991
"47093005808","Census Tract 58.08, Knox County, Tennessee",4934,4621,313,0.936562626672071,0.0634373733279286
"47093005809","Census Tract 58.09, Knox County, Tennessee",4861,4310,551,0.886648837687719,0.113351162312281
"47093005810","Census Tract 58.10, Knox County, Tennessee",3791,3402,389,0.897388551833289,0.102611448166711
"47093005811","Census Tract 58.11, Knox County, Tennessee",2843,2428,415,0.854027435807246,0.145972564192754
"47093005812","Census Tract 58.12, Knox County, Tennessee",4485,4059,426,0.905016722408027,0.0949832775919732
"47093005813","Census Tract 58.13, Knox County, Tennessee",5189,4603,586,0.887068799383311,0.112931200616689
"47093005903","Census Tract 59.03, Knox County, Tennessee",3167,2828,339,0.89295863593306,0.10704136406694
"47093005904","Census Tract 59.04, Knox County, Tennessee",4681,4442,239,0.948942533646657,0.0510574663533433
"47093005905","Census Tract 59.05, Knox County, Tennessee",1901,1874,27,0.985796948974224,0.0142030510257759
"47093005906","Census Tract 59.06, Knox County, Tennessee",1430,1400,30,0.979020979020979,0.0209790209790209
"47093005907","Census Tract 59.07, Knox County, Tennessee",2614,2302,312,0.880642693190513,0.119357306809487
"47093005908","Census Tract 59.08, Knox County, Tennessee",4400,3936,464,0.894545454545455,0.105454545454545
"47093006001","Census Tract 60.01, Knox County, Tennessee",2827,2622,205,0.927484966395472,0.0725150336045278
"47093006002","Census Tract 60.02, Knox County, Tennessee",5645,5362,283,0.949867139061116,0.0501328609388839
"47093006003","Census Tract 60.03, Knox County, Tennessee",3906,3606,300,0.923195084485407,0.0768049155145929
"47093006102","Census Tract 61.02, Knox County, Tennessee",5188,5058,130,0.974942174248265,0.0250578257517348
"47093006103","Census Tract 61.03, Knox County, Tennessee",5309,5059,250,0.952910152571106,0.0470898474288943
"47093006104","Census Tract 61.04, Knox County, Tennessee",4997,4443,554,0.889133480088053,0.110866519911947
"47093006202","Census Tract 62.02, Knox County, Tennessee",5087,4874,213,0.958128563003735,0.0418714369962649
"47093006203","Census Tract 62.03, Knox County, Tennessee",5112,5085,27,0.994718309859155,0.00528169014084512
"47093006205","Census Tract 62.05, Knox County, Tennessee",3863,3808,55,0.985762360859436,0.0142376391405643
"47093006206","Census Tract 62.06, Knox County, Tennessee",4787,4743,44,0.99080843952371,0.00919156047628999
"47093006207","Census Tract 62.07, Knox County, Tennessee",3180,2850,330,0.89622641509434,0.10377358490566
"47093006208","Census Tract 62.08, Knox County, Tennessee",5017,4915,102,0.979669124975085,0.0203308750249153
"47093006301","Census Tract 63.01, Knox County, Tennessee",3329,3276,53,0.984079303094022,0.0159206969059777
"47093006302","Census Tract 63.02, Knox County, Tennessee",3108,2992,116,0.962676962676963,0.0373230373230373
"47093006401","Census Tract 64.01, Knox County, Tennessee",4089,3954,135,0.966984592809978,0.0330154071900221
"47093006402","Census Tract 64.02, Knox County, Tennessee",4816,4771,45,0.990656146179402,0.00934385382059799
"47093006403","Census Tract 64.03, Knox County, Tennessee",2709,2647,62,0.977113325950535,0.0228866740494648
"47093006501","Census Tract 65.01, Knox County, Tennessee",3080,2876,204,0.933766233766234,0.0662337662337662
"47093006502","Census Tract 65.02, Knox County, Tennessee",2839,2751,88,0.969003170130328,0.0309968298696724
"47093006600","Census Tract 66, Knox County, Tennessee",2902,2504,398,0.862853204686423,0.137146795313577
"47093006700","Census Tract 67, Knox County, Tennessee",2795,1203,1592,0.4304114490161,0.5695885509839
"47093006800","Census Tract 68, Knox County, Tennessee",4421,865,3556,0.195657091155847,0.804342908844153
"47093006900","Census Tract 69, Knox County, Tennessee",4500,3756,744,0.834666666666667,0.165333333333333
"47093007000","Census Tract 70, Knox County, Tennessee",2280,960,1320,0.421052631578947,0.578947368421053
"47093007100","Census Tract 71, Knox County, Tennessee",4066,3900,166,0.959173635022135,0.0408263649778652
"47095960100","Census Tract 9601, Lake County, Tennessee",5459,3560,1899,0.652134090492764,0.347865909507236
"47095960200","Census Tract 9602, Lake County, Tennessee",2368,1832,536,0.773648648648649,0.226351351351351
"47097050100","Census Tract 501, Lauderdale County, Tennessee",3532,1881,1651,0.532559456398641,0.467440543601359
"47097050200","Census Tract 502, Lauderdale County, Tennessee",3835,3168,667,0.826075619295958,0.173924380704042
"47097050300","Census Tract 503, Lauderdale County, Tennessee",3162,2432,730,0.769133459835547,0.230866540164453
"47097050400","Census Tract 504, Lauderdale County, Tennessee",3187,2803,384,0.879510511452777,0.120489488547223
"47097050503","Census Tract 505.03, Lauderdale County, Tennessee",2332,1877,455,0.804888507718696,0.195111492281304
"47097050504","Census Tract 505.04, Lauderdale County, Tennessee",2584,1508,1076,0.58359133126935,0.41640866873065
"47097050505","Census Tract 505.05, Lauderdale County, Tennessee",4077,1217,2860,0.29850380181506,0.70149619818494
"47097050506","Census Tract 505.06, Lauderdale County, Tennessee",2452,1484,968,0.605220228384992,0.394779771615008
"47097050600","Census Tract 506, Lauderdale County, Tennessee",2584,1059,1525,0.409829721362229,0.590170278637771
"47099960100","Census Tract 9601, Lawrence County, Tennessee",3657,3649,8,0.997812414547443,0.00218758545255671
"47099960200","Census Tract 9602, Lawrence County, Tennessee",2669,2607,62,0.976770325964781,0.0232296740352191
"47099960300","Census Tract 9603, Lawrence County, Tennessee",4792,4695,97,0.979757929883139,0.0202420701168614
"47099960401","Census Tract 9604.01, Lawrence County, Tennessee",5583,5297,286,0.948773061078273,0.0512269389217267
"47099960402","Census Tract 9604.02, Lawrence County, Tennessee",4232,4099,133,0.968572778827977,0.0314272211720227
"47099960501","Census Tract 9605.01, Lawrence County, Tennessee",4508,4064,444,0.90150842945874,0.09849157054126
"47099960502","Census Tract 9605.02, Lawrence County, Tennessee",4127,3938,189,0.954204022292222,0.0457959777077781
"47099960600","Census Tract 9606, Lawrence County, Tennessee",2299,2204,95,0.958677685950413,0.0413223140495868
"47099960700","Census Tract 9607, Lawrence County, Tennessee",4001,3817,184,0.954011497125719,0.0459885028742815
"47099960800","Census Tract 9608, Lawrence County, Tennessee",3602,3561,41,0.988617434758468,0.0113825652415325
"47099960900","Census Tract 9609, Lawrence County, Tennessee",1849,1656,193,0.895619253650622,0.104380746349378
"47101970100","Census Tract 9701, Lewis County, Tennessee",4591,4591,0,1,0
"47101970200","Census Tract 9702, Lewis County, Tennessee",7412,6889,523,0.929438747976255,0.0705612520237453
"47103975000","Census Tract 9750, Lincoln County, Tennessee",1531,1360,171,0.888308295231875,0.111691704768125
"47103975100","Census Tract 9751, Lincoln County, Tennessee",2463,2233,230,0.906617945594803,0.0933820544051969
"47103975200","Census Tract 9752, Lincoln County, Tennessee",2367,2353,14,0.994085340092945,0.00591465990705531
"47103975300","Census Tract 9753, Lincoln County, Tennessee",5711,4078,1633,0.714060584836281,0.285939415163719
"47103975400","Census Tract 9754, Lincoln County, Tennessee",3849,3315,534,0.861262665627436,0.138737334372564
"47103975500","Census Tract 9755, Lincoln County, Tennessee",5083,4944,139,0.972653944520952,0.0273460554790478
"47103975601","Census Tract 9756.01, Lincoln County, Tennessee",4597,4332,265,0.942353708940613,0.0576462910593866
"47103975602","Census Tract 9756.02, Lincoln County, Tennessee",3875,3636,239,0.938322580645161,0.0616774193548387
"47103975700","Census Tract 9757, Lincoln County, Tennessee",3409,3263,146,0.957172191258434,0.0428278087415664
"47105060100","Census Tract 601, Loudon County, Tennessee",4606,4558,48,0.989578810247503,0.0104211897524967
"47105060201","Census Tract 602.01, Loudon County, Tennessee",3910,3755,155,0.960358056265985,0.0396419437340153
"47105060202","Census Tract 602.02, Loudon County, Tennessee",7782,7072,710,0.908763813929581,0.0912361860704189
"47105060301","Census Tract 603.01, Loudon County, Tennessee",3178,3079,99,0.968848332284456,0.0311516677155443
"47105060302","Census Tract 603.02, Loudon County, Tennessee",5951,5832,119,0.980003360779701,0.0199966392202992
"47105060400","Census Tract 604, Loudon County, Tennessee",4344,4205,139,0.968001841620626,0.0319981583793738
"47105060501","Census Tract 605.01, Loudon County, Tennessee",8204,8152,52,0.993661628473915,0.00633837152608485
"47105060502","Census Tract 605.02, Loudon County, Tennessee",2079,2035,44,0.978835978835979,0.0211640211640212
"47105060600","Census Tract 606, Loudon County, Tennessee",4477,3832,645,0.855930310475765,0.144069689524235
"47105060700","Census Tract 607, Loudon County, Tennessee",2571,2556,15,0.99416569428238,0.00583430571761956
"47107970101","Census Tract 9701.01, McMinn County, Tennessee",6333,6208,125,0.980262119058898,0.0197378809411022
"47107970102","Census Tract 9701.02, McMinn County, Tennessee",4320,4084,236,0.94537037037037,0.0546296296296296
"47107970200","Census Tract 9702, McMinn County, Tennessee",6538,5418,1120,0.828693790149893,0.171306209850107
"47107970300","Census Tract 9703, McMinn County, Tennessee",2959,2691,268,0.909428861101724,0.0905711388982764
"47107970401","Census Tract 9704.01, McMinn County, Tennessee",3128,3019,109,0.965153452685422,0.034846547314578
"47107970402","Census Tract 9704.02, McMinn County, Tennessee",5180,4764,416,0.91969111969112,0.0803088803088803
"47107970500","Census Tract 9705, McMinn County, Tennessee",4224,3983,241,0.942945075757576,0.0570549242424242
"47107970600","Census Tract 9706, McMinn County, Tennessee",7378,7207,171,0.97682298725942,0.0231770127405801
"47107970700","Census Tract 9707, McMinn County, Tennessee",4286,3980,306,0.928604759682688,0.0713952403173121
"47107970800","Census Tract 9708, McMinn County, Tennessee",7729,7214,515,0.933367835425023,0.0666321645749773
"47109930100","Census Tract 9301, McNairy County, Tennessee",4235,4070,165,0.961038961038961,0.038961038961039
"47109930200","Census Tract 9302, McNairy County, Tennessee",2238,2221,17,0.992403932082216,0.00759606791778378
"47109930300","Census Tract 9303, McNairy County, Tennessee",3107,2774,333,0.892822658513035,0.107177341486965
"47109930400","Census Tract 9304, McNairy County, Tennessee",1925,1740,185,0.903896103896104,0.0961038961038961
"47109930500","Census Tract 9305, McNairy County, Tennessee",7263,6360,903,0.875671210243701,0.124328789756299
"47109930600","Census Tract 9306, McNairy County, Tennessee",3712,3442,270,0.927262931034483,0.0727370689655172
"47109930700","Census Tract 9307, McNairy County, Tennessee",3280,3149,131,0.960060975609756,0.0399390243902439
"47111970100","Census Tract 9701, Macon County, Tennessee",5010,4775,235,0.953093812375249,0.0469061876247505
"47111970200","Census Tract 9702, Macon County, Tennessee",5498,5354,144,0.973808657693707,0.0261913423062932
"47111970300","Census Tract 9703, Macon County, Tennessee",7061,6858,203,0.971250531086248,0.0287494689137516
"47111970400","Census Tract 9704, Macon County, Tennessee",4365,4308,57,0.986941580756014,0.0130584192439862
"47113000100","Census Tract 1, Madison County, Tennessee",3760,1652,2108,0.43936170212766,0.56063829787234
"47113000200","Census Tract 2, Madison County, Tennessee",5983,2339,3644,0.390940999498579,0.609059000501421
"47113000300","Census Tract 3, Madison County, Tennessee",4463,3043,1420,0.681828366569572,0.318171633430428
"47113000400","Census Tract 4, Madison County, Tennessee",3691,807,2884,0.218639934976971,0.781360065023029
"47113000500","Census Tract 5, Madison County, Tennessee",4662,287,4375,0.0615615615615616,0.938438438438438
"47113000600","Census Tract 6, Madison County, Tennessee",2300,1290,1010,0.560869565217391,0.439130434782609
"47113000700","Census Tract 7, Madison County, Tennessee",2461,1331,1130,0.540837058106461,0.459162941893539
"47113000800","Census Tract 8, Madison County, Tennessee",1141,225,916,0.197195442594216,0.802804557405784
"47113000900","Census Tract 9, Madison County, Tennessee",2732,49,2683,0.0179355783308931,0.982064421669107
"47113001000","Census Tract 10, Madison County, Tennessee",2480,347,2133,0.13991935483871,0.86008064516129
"47113001100","Census Tract 11, Madison County, Tennessee",1055,27,1028,0.0255924170616114,0.974407582938389
"47113001300","Census Tract 13, Madison County, Tennessee",6139,5483,656,0.89314220557094,0.10685779442906
"47113001401","Census Tract 14.01, Madison County, Tennessee",2138,1649,489,0.771281571562208,0.228718428437792
"47113001402","Census Tract 14.02, Madison County, Tennessee",2178,1828,350,0.839302112029385,0.160697887970615
"47113001501","Census Tract 15.01, Madison County, Tennessee",4676,3075,1601,0.657613344739093,0.342386655260907
"47113001502","Census Tract 15.02, Madison County, Tennessee",5937,5419,518,0.912750547414519,0.0872494525854809
"47113001603","Census Tract 16.03, Madison County, Tennessee",2454,1788,666,0.728606356968215,0.271393643031785
"47113001604","Census Tract 16.04, Madison County, Tennessee",3274,2518,756,0.769089798411729,0.230910201588271
"47113001605","Census Tract 16.05, Madison County, Tennessee",2224,1474,750,0.662769784172662,0.337230215827338
"47113001606","Census Tract 16.06, Madison County, Tennessee",9263,5594,3669,0.603908021159452,0.396091978840548
"47113001607","Census Tract 16.07, Madison County, Tennessee",5774,4121,1653,0.713716660893661,0.286283339106339
"47113001608","Census Tract 16.08, Madison County, Tennessee",2206,1980,226,0.897552130553037,0.102447869446963
"47113001609","Census Tract 16.09, Madison County, Tennessee",1734,1426,308,0.82237600922722,0.17762399077278
"47113001610","Census Tract 16.10, Madison County, Tennessee",5103,4408,695,0.863805604546345,0.136194395453655
"47113001700","Census Tract 17, Madison County, Tennessee",1623,992,631,0.611213801601972,0.388786198398028
"47113001800","Census Tract 18, Madison County, Tennessee",3640,2516,1124,0.691208791208791,0.308791208791209
"47113001900","Census Tract 19, Madison County, Tennessee",4287,3879,408,0.90482855143457,0.0951714485654304
"47115050101","Census Tract 501.01, Marion County, Tennessee",3312,3177,135,0.959239130434783,0.0407608695652174
"47115050102","Census Tract 501.02, Marion County, Tennessee",6743,6521,222,0.96707696870829,0.0329230312917099
"47115050201","Census Tract 502.01, Marion County, Tennessee",4320,4030,290,0.93287037037037,0.0671296296296297
"47115050202","Census Tract 502.02, Marion County, Tennessee",5503,5013,490,0.910957659458477,0.0890423405415228
"47115050301","Census Tract 503.01, Marion County, Tennessee",5444,5009,435,0.920095518001469,0.0799044819985305
"47115050302","Census Tract 503.02, Marion County, Tennessee",2801,2733,68,0.975722956087112,0.0242770439128882
"47117955000","Census Tract 9550, Marshall County, Tennessee",6371,6202,169,0.973473552032648,0.026526447967352
"47117955100","Census Tract 9551, Marshall County, Tennessee",5424,5059,365,0.932706489675516,0.0672935103244838
"47117955200","Census Tract 9552, Marshall County, Tennessee",5029,4293,736,0.853648836746868,0.146351163253132
"47117955300","Census Tract 9553, Marshall County, Tennessee",4293,3050,1243,0.710458886559516,0.289541113440484
"47117955400","Census Tract 9554, Marshall County, Tennessee",3964,3682,282,0.928859737638749,0.0711402623612513
"47117955500","Census Tract 9555, Marshall County, Tennessee",4821,4395,426,0.911636589919104,0.0883634100808961
"47119010100","Census Tract 101, Maury County, Tennessee",3275,3133,142,0.956641221374046,0.0433587786259542
"47119010201","Census Tract 102.01, Maury County, Tennessee",5690,5202,488,0.914235500878735,0.0857644991212654
"47119010202","Census Tract 102.02, Maury County, Tennessee",6384,5699,685,0.892700501253133,0.107299498746867
"47119010301","Census Tract 103.01, Maury County, Tennessee",5543,4675,868,0.843406097780985,0.156593902219015
"47119010302","Census Tract 103.02, Maury County, Tennessee",2718,2257,461,0.830389992641648,0.169610007358352
"47119010400","Census Tract 104, Maury County, Tennessee",5975,5002,973,0.837154811715481,0.162845188284519
"47119010500","Census Tract 105, Maury County, Tennessee",4442,2096,2346,0.471859522737506,0.528140477262494
"47119010600","Census Tract 106, Maury County, Tennessee",5124,3619,1505,0.706284153005464,0.293715846994536
"47119010700","Census Tract 107, Maury County, Tennessee",4283,3691,592,0.861779126780294,0.138220873219706
"47119010801","Census Tract 108.01, Maury County, Tennessee",3438,3198,240,0.930191972076789,0.0698080279232112
"47119010802","Census Tract 108.02, Maury County, Tennessee",6846,5438,1408,0.794332456909144,0.205667543090856
"47119010900","Census Tract 109, Maury County, Tennessee",3564,3025,539,0.848765432098765,0.151234567901235
"47119011001","Census Tract 110.01, Maury County, Tennessee",2708,2501,207,0.923559822747415,0.0764401772525849
"47119011002","Census Tract 110.02, Maury County, Tennessee",6372,5110,1262,0.801946013810421,0.198053986189579
"47119011101","Census Tract 111.01, Maury County, Tennessee",4139,3877,262,0.936699685914472,0.0633003140855279
"47119011102","Census Tract 111.02, Maury County, Tennessee",3128,2363,765,0.755434782608696,0.244565217391304
"47119011200","Census Tract 112, Maury County, Tennessee",5400,4966,434,0.91962962962963,0.0803703703703704
"47121960100","Census Tract 9601, Meigs County, Tennessee",3627,3610,17,0.995312930796802,0.00468706920319828
"47121960200","Census Tract 9602, Meigs County, Tennessee",4260,4139,121,0.971596244131455,0.0284037558685446
"47121960300","Census Tract 9603, Meigs County, Tennessee",3694,3529,165,0.955332972387656,0.0446670276123443
"47123925000","Census Tract 9250, Monroe County, Tennessee",7085,6876,209,0.970501058574453,0.0294989414255469
"47123925100","Census Tract 9251, Monroe County, Tennessee",8119,7558,561,0.930902820544402,0.069097179455598
"47123925200","Census Tract 9252, Monroe County, Tennessee",4372,3476,896,0.795059469350412,0.204940530649588
"47123925300","Census Tract 9253, Monroe County, Tennessee",7475,7362,113,0.984882943143813,0.0151170568561872
"47123925400","Census Tract 9254, Monroe County, Tennessee",8376,8058,318,0.962034383954155,0.0379656160458453
"47123925501","Census Tract 9255.01, Monroe County, Tennessee",2816,2751,65,0.976917613636364,0.0230823863636364
"47123925502","Census Tract 9255.02, Monroe County, Tennessee",5772,5579,193,0.966562716562717,0.0334372834372835
"47125100100","Census Tract 1001, Montgomery County, Tennessee",1006,661,345,0.657057654075547,0.342942345924453
"47125100200","Census Tract 1002, Montgomery County, Tennessee",1842,1127,715,0.611834961997828,0.388165038002172
"47125100300","Census Tract 1003, Montgomery County, Tennessee",5021,3960,1061,0.78868751244772,0.21131248755228
"47125100400","Census Tract 1004, Montgomery County, Tennessee",2479,1313,1166,0.529649052037112,0.470350947962888
"47125100500","Census Tract 1005, Montgomery County, Tennessee",4880,3846,1034,0.788114754098361,0.211885245901639
"47125100601","Census Tract 1006.01, Montgomery County, Tennessee",2278,1990,288,0.873573309920983,0.126426690079017
"47125100602","Census Tract 1006.02, Montgomery County, Tennessee",2948,2748,200,0.932157394843962,0.067842605156038
"47125100700","Census Tract 1007, Montgomery County, Tennessee",1231,753,478,0.611697806661251,0.388302193338749
"47125100800","Census Tract 1008, Montgomery County, Tennessee",2878,1411,1467,0.490271021542738,0.509728978457262
"47125100900","Census Tract 1009, Montgomery County, Tennessee",2827,1259,1568,0.445348425893173,0.554651574106827
"47125101001","Census Tract 1010.01, Montgomery County, Tennessee",4826,2954,1872,0.61210111893908,0.38789888106092
"47125101002","Census Tract 1010.02, Montgomery County, Tennessee",3251,1658,1593,0.509996924023377,0.490003075976623
"47125101101","Census Tract 1011.01, Montgomery County, Tennessee",2679,1558,1121,0.581560283687943,0.418439716312057
"47125101102","Census Tract 1011.02, Montgomery County, Tennessee",7890,5097,2793,0.646007604562738,0.353992395437262
"47125101103","Census Tract 1011.03, Montgomery County, Tennessee",2441,2009,432,0.823023351085621,0.176976648914379
"47125101201","Census Tract 1012.01, Montgomery County, Tennessee",2311,1028,1283,0.444829078321073,0.555170921678927
"47125101202","Census Tract 1012.02, Montgomery County, Tennessee",3872,2840,1032,0.733471074380165,0.266528925619835
"47125101303","Census Tract 1013.03, Montgomery County, Tennessee",6101,3082,3019,0.505163088018358,0.494836911981642
"47125101304","Census Tract 1013.04, Montgomery County, Tennessee",4649,2998,1651,0.644869864486986,0.355130135513014
"47125101305","Census Tract 1013.05, Montgomery County, Tennessee",2924,1531,1393,0.52359781121751,0.47640218878249
"47125101306","Census Tract 1013.06, Montgomery County, Tennessee",4456,2456,2000,0.551166965888689,0.448833034111311
"47125101307","Census Tract 1013.07, Montgomery County, Tennessee",2240,1317,923,0.587946428571429,0.412053571428571
"47125101400","Census Tract 1014, Montgomery County, Tennessee",5651,4042,1609,0.715271633339232,0.284728366660768
"47125101500","Census Tract 1015, Montgomery County, Tennessee",7504,6450,1054,0.85954157782516,0.14045842217484
"47125101600","Census Tract 1016, Montgomery County, Tennessee",5185,4579,606,0.883124397299904,0.116875602700096
"47125101700","Census Tract 1017, Montgomery County, Tennessee",7472,7199,273,0.963463597430407,0.0365364025695931
"47125101802","Census Tract 1018.02, Montgomery County, Tennessee",9960,9430,530,0.946787148594378,0.0532128514056225
"47125101803","Census Tract 1018.03, Montgomery County, Tennessee",6464,5636,828,0.871905940594059,0.128094059405941
"47125101804","Census Tract 1018.04, Montgomery County, Tennessee",5618,4802,816,0.854752580989676,0.145247419010324
"47125101902","Census Tract 1019.02, Montgomery County, Tennessee",2372,2239,133,0.943929173693086,0.056070826306914
"47125101903","Census Tract 1019.03, Montgomery County, Tennessee",7526,5690,1836,0.756045708211533,0.243954291788467
"47125101904","Census Tract 1019.04, Montgomery County, Tennessee",1740,1597,143,0.917816091954023,0.082183908045977
"47125102001","Census Tract 1020.01, Montgomery County, Tennessee",4233,3045,1188,0.719347980155918,0.280652019844082
"47125102002","Census Tract 1020.02, Montgomery County, Tennessee",6004,4692,1312,0.781479013990673,0.218520986009327
"47125102003","Census Tract 1020.03, Montgomery County, Tennessee",4732,2270,2462,0.47971259509721,0.520287404902789
"47125102004","Census Tract 1020.04, Montgomery County, Tennessee",4290,2617,1673,0.61002331002331,0.38997668997669
"47125102005","Census Tract 1020.05, Montgomery County, Tennessee",4256,2573,1683,0.604558270676692,0.395441729323308
"47125102006","Census Tract 1020.06, Montgomery County, Tennessee",5566,4106,1460,0.737693136902623,0.262306863097377
"47127930100","Census Tract 9301, Moore County, Tennessee",3504,3343,161,0.954052511415525,0.0459474885844748
"47127930200","Census Tract 9302, Moore County, Tennessee",2762,2561,201,0.927226647356988,0.0727733526430123
"47129110100","Census Tract 1101, Morgan County, Tennessee",2952,2839,113,0.961720867208672,0.0382791327913279
"47129110200","Census Tract 1102, Morgan County, Tennessee",3541,3521,20,0.994351878000565,0.00564812199943521
"47129110300","Census Tract 1103, Morgan County, Tennessee",5789,4976,813,0.859561236828468,0.140438763171532
"47129110400","Census Tract 1104, Morgan County, Tennessee",4364,4272,92,0.978918423464711,0.0210815765352887
"47129110500","Census Tract 1105, Morgan County, Tennessee",5018,4912,106,0.978876046233559,0.0211239537664408
"47131965000","Census Tract 9650, Obion County, Tennessee",3994,3428,566,0.85828743114672,0.14171256885328
"47131965100","Census Tract 9651, Obion County, Tennessee",2597,2485,112,0.956873315363881,0.0431266846361186
"47131965200","Census Tract 9652, Obion County, Tennessee",2240,2223,17,0.992410714285714,0.00758928571428574
"47131965300","Census Tract 9653, Obion County, Tennessee",3738,3625,113,0.969769930444088,0.0302300695559122
"47131965400","Census Tract 9654, Obion County, Tennessee",4674,4468,206,0.955926401369277,0.0440735986307231
"47131965500","Census Tract 9655, Obion County, Tennessee",2406,2153,253,0.894846217788861,0.105153782211139
"47131965600","Census Tract 9656, Obion County, Tennessee",4344,2559,1785,0.589088397790055,0.410911602209945
"47131965700","Census Tract 9657, Obion County, Tennessee",4618,3757,861,0.813555651797315,0.186444348202685
"47131965800","Census Tract 9658, Obion County, Tennessee",1904,1830,74,0.961134453781513,0.0388655462184874
"47131965900","Census Tract 9659, Obion County, Tennessee",1390,1326,64,0.953956834532374,0.0460431654676259
"47133950100","Census Tract 9501, Overton County, Tennessee",1503,1478,25,0.983366600133067,0.0166333998669328
"47133950200","Census Tract 9502, Overton County, Tennessee",1669,1624,45,0.973037747153984,0.0269622528460156
"47133950301","Census Tract 9503.01, Overton County, Tennessee",4646,4646,0,1,0
"47133950302","Census Tract 9503.02, Overton County, Tennessee",3198,3054,144,0.954971857410882,0.0450281425891182
"47133950400","Census Tract 9504, Overton County, Tennessee",2143,2123,20,0.99066728884741,0.00933271115258982
"47133950500","Census Tract 9505, Overton County, Tennessee",6184,5866,318,0.948576972833118,0.0514230271668823
"47133950600","Census Tract 9506, Overton County, Tennessee",2434,2434,0,1,0
"47135930100","Census Tract 9301, Perry County, Tennessee",3138,2983,155,0.950605481198215,0.0493945188017846
"47135930200","Census Tract 9302, Perry County, Tennessee",4640,4433,207,0.955387931034483,0.0446120689655173
"47137925100","Census Tract 9251, Pickett County, Tennessee",5072,4935,137,0.972988958990536,0.0270110410094637
"47139950100","Census Tract 9501, Polk County, Tennessee",1311,1303,8,0.993897787948131,0.00610221205186878
"47139950201","Census Tract 9502.01, Polk County, Tennessee",1826,1792,34,0.981380065717415,0.0186199342825849
"47139950202","Census Tract 9502.02, Polk County, Tennessee",6291,6281,10,0.998410427594977,0.001589572405023
"47139950300","Census Tract 9503, Polk County, Tennessee",3582,3520,62,0.982691233947515,0.0173087660524847
"47139950400","Census Tract 9504, Polk County, Tennessee",3680,3450,230,0.9375,0.0625
"47141000100","Census Tract 1, Putnam County, Tennessee",6085,5940,145,0.976170912078883,0.0238290879211175
"47141000200","Census Tract 2, Putnam County, Tennessee",8262,7737,525,0.936456063907044,0.0635439360929557
"47141000301","Census Tract 3.01, Putnam County, Tennessee",2375,2268,107,0.954947368421053,0.0450526315789473
"47141000302","Census Tract 3.02, Putnam County, Tennessee",6323,5719,604,0.904475723548948,0.0955242764510518
"47141000303","Census Tract 3.03, Putnam County, Tennessee",2261,2014,247,0.890756302521008,0.109243697478992
"47141000400","Census Tract 4, Putnam County, Tennessee",3755,3461,294,0.921704394141145,0.0782956058588549
"47141000500","Census Tract 5, Putnam County, Tennessee",1609,1594,15,0.990677439403356,0.00932256059664383
"47141000600","Census Tract 6, Putnam County, Tennessee",3737,3414,323,0.913567032378914,0.0864329676210864
"47141000700","Census Tract 7, Putnam County, Tennessee",3265,3114,151,0.95375191424196,0.0462480857580398
"47141000800","Census Tract 8, Putnam County, Tennessee",6035,5317,718,0.88102734051367,0.11897265948633
"47141000900","Census Tract 9, Putnam County, Tennessee",5947,5913,34,0.994282831679839,0.00571716832016145
"47141001000","Census Tract 10, Putnam County, Tennessee",3506,3367,139,0.960353679406731,0.0396463205932687
"47141001100","Census Tract 11, Putnam County, Tennessee",6509,6221,288,0.955753571977262,0.0442464280227377
"47141001200","Census Tract 12, Putnam County, Tennessee",8236,7942,294,0.964303059737737,0.0356969402622632
"47141001300","Census Tract 13, Putnam County, Tennessee",2665,2468,197,0.926078799249531,0.073921200750469
"47143975000","Census Tract 9750, Rhea County, Tennessee",4617,4325,292,0.936755468919212,0.0632445310807884
"47143975100","Census Tract 9751, Rhea County, Tennessee",4496,4440,56,0.987544483985765,0.0124555160142349
"47143975200","Census Tract 9752, Rhea County, Tennessee",6200,5992,208,0.966451612903226,0.0335483870967742
"47143975300","Census Tract 9753, Rhea County, Tennessee",5861,5498,363,0.938065176591025,0.0619348234089746
"47143975401","Census Tract 9754.01, Rhea County, Tennessee",6469,6025,444,0.931364971402071,0.0686350285979286
"47143975402","Census Tract 9754.02, Rhea County, Tennessee",3572,3239,333,0.906774916013438,0.0932250839865622
"47145030100","Census Tract 301, Roane County, Tennessee",3234,2968,266,0.917748917748918,0.0822510822510822
"47145030201","Census Tract 302.01, Roane County, Tennessee",6556,6496,60,0.9908480780964,0.0091519219035997
"47145030202","Census Tract 302.02, Roane County, Tennessee",7142,6487,655,0.908288994679362,0.0917110053206385
"47145030300","Census Tract 303, Roane County, Tennessee",7173,6932,241,0.966401784469539,0.0335982155304615
"47145030400","Census Tract 304, Roane County, Tennessee",6469,6294,175,0.972947905394961,0.0270520946050394
"47145030500","Census Tract 305, Roane County, Tennessee",3945,3621,324,0.91787072243346,0.0821292775665399
"47145030600","Census Tract 306, Roane County, Tennessee",3866,3608,258,0.933264355923435,0.066735644076565
"47145030700","Census Tract 307, Roane County, Tennessee",4627,4450,177,0.961746271882429,0.0382537281175708
"47145030800","Census Tract 308, Roane County, Tennessee",5752,5371,381,0.933762169680111,0.0662378303198887
"47145030900","Census Tract 309, Roane County, Tennessee",5392,5260,132,0.975519287833828,0.0244807121661721
"47147080101","Census Tract 801.01, Robertson County, Tennessee",3673,3510,163,0.955622107269262,0.0443778927307378
"47147080103","Census Tract 801.03, Robertson County, Tennessee",5713,5559,154,0.973043934885349,0.0269560651146508
"47147080104","Census Tract 801.04, Robertson County, Tennessee",6442,6244,198,0.969264203663459,0.0307357963365414
"47147080200","Census Tract 802, Robertson County, Tennessee",5717,5243,474,0.917089382543292,0.082910617456708
"47147080301","Census Tract 803.01, Robertson County, Tennessee",2833,2056,777,0.725732439110484,0.274267560889516
"47147080302","Census Tract 803.02, Robertson County, Tennessee",2859,1613,1246,0.564183280867436,0.435816719132564
"47147080401","Census Tract 804.01, Robertson County, Tennessee",4894,3323,1571,0.678994687372293,0.321005312627707
"47147080402","Census Tract 804.02, Robertson County, Tennessee",4356,3829,527,0.879017447199265,0.120982552800735
"47147080500","Census Tract 805, Robertson County, Tennessee",3916,3700,216,0.944841675178754,0.0551583248212462
"47147080603","Census Tract 806.03, Robertson County, Tennessee",4846,4450,396,0.918283120099051,0.0817168799009492
"47147080604","Census Tract 806.04, Robertson County, Tennessee",3564,3560,4,0.998877665544332,0.00112233445566778
"47147080605","Census Tract 806.05, Robertson County, Tennessee",2999,2854,145,0.951650550183395,0.0483494498166055
"47147080606","Census Tract 806.06, Robertson County, Tennessee",5393,5290,103,0.980901168180975,0.0190988318190246
"47147080700","Census Tract 807, Robertson County, Tennessee",7142,6524,618,0.913469616353963,0.0865303836460375
"47149040101","Census Tract 401.01, Rutherford County, Tennessee",3239,2709,530,0.836369249768447,0.163630750231553
"47149040102","Census Tract 401.02, Rutherford County, Tennessee",3133,2431,702,0.775933609958506,0.224066390041494
"47149040103","Census Tract 401.03, Rutherford County, Tennessee",6324,3623,2701,0.572896900695762,0.427103099304238
"47149040104","Census Tract 401.04, Rutherford County, Tennessee",4815,3254,1561,0.675804776739356,0.324195223260644
"47149040105","Census Tract 401.05, Rutherford County, Tennessee",4145,3172,973,0.765259348612786,0.234740651387214
"47149040200","Census Tract 402, Rutherford County, Tennessee",3809,2962,847,0.777631924389604,0.222368075610396
"47149040302","Census Tract 403.02, Rutherford County, Tennessee",8752,7214,1538,0.82426873857404,0.17573126142596
"47149040303","Census Tract 403.03, Rutherford County, Tennessee",1997,1614,383,0.808212318477717,0.191787681522283
"47149040304","Census Tract 403.04, Rutherford County, Tennessee",2110,1776,334,0.841706161137441,0.158293838862559
"47149040305","Census Tract 403.05, Rutherford County, Tennessee",2167,1508,659,0.695892939547762,0.304107060452238
"47149040306","Census Tract 403.06, Rutherford County, Tennessee",3293,2773,520,0.842089280291528,0.157910719708472
"47149040307","Census Tract 403.07, Rutherford County, Tennessee",3025,2730,295,0.902479338842975,0.0975206611570248
"47149040308","Census Tract 403.08, Rutherford County, Tennessee",5480,4202,1278,0.766788321167883,0.233211678832117
"47149040403","Census Tract 404.03, Rutherford County, Tennessee",6969,6062,907,0.869852202611565,0.130147797388435
"47149040501","Census Tract 405.01, Rutherford County, Tennessee",6375,5989,386,0.939450980392157,0.0605490196078431
"47149040502","Census Tract 405.02, Rutherford County, Tennessee",7105,6363,742,0.895566502463054,0.104433497536946
"47149040600","Census Tract 406, Rutherford County, Tennessee",3930,3659,271,0.931043256997455,0.0689567430025445
"47149040701","Census Tract 407.01, Rutherford County, Tennessee",8159,7011,1148,0.85929648241206,0.14070351758794
"47149040702","Census Tract 407.02, Rutherford County, Tennessee",4656,4122,534,0.885309278350515,0.114690721649485
"47149040805","Census Tract 408.05, Rutherford County, Tennessee",7981,6137,1844,0.768951259240697,0.231048740759303
"47149040806","Census Tract 408.06, Rutherford County, Tennessee",6603,6190,413,0.937452673027412,0.0625473269725882
"47149040807","Census Tract 408.07, Rutherford County, Tennessee",4096,3729,367,0.910400390625,0.089599609375
"47149040808","Census Tract 408.08, Rutherford County, Tennessee",6066,5401,665,0.890372568414111,0.109627431585889
"47149040809","Census Tract 408.09, Rutherford County, Tennessee",3548,3116,432,0.878241262683202,0.121758737316798
"47149040810","Census Tract 408.10, Rutherford County, Tennessee",2130,1998,132,0.938028169014084,0.0619718309859155
"47149040901","Census Tract 409.01, Rutherford County, Tennessee",2352,2110,242,0.897108843537415,0.102891156462585
"47149040902","Census Tract 409.02, Rutherford County, Tennessee",6667,5883,784,0.882405879706015,0.117594120293985
"47149040903","Census Tract 409.03, Rutherford County, Tennessee",8363,6462,1901,0.772689226354179,0.227310773645821
"47149040904","Census Tract 409.04, Rutherford County, Tennessee",4837,3709,1128,0.766797601819309,0.233202398180691
"47149040905","Census Tract 409.05, Rutherford County, Tennessee",7079,5411,1668,0.764373499081791,0.235626500918209
"47149041000","Census Tract 410, Rutherford County, Tennessee",6364,5396,968,0.847894406033941,0.152105593966059
"47149041101","Census Tract 411.01, Rutherford County, Tennessee",7516,6442,1074,0.857104843001597,0.142895156998403
"47149041102","Census Tract 411.02, Rutherford County, Tennessee",3217,2578,639,0.801367733913584,0.198632266086416
"47149041201","Census Tract 412.01, Rutherford County, Tennessee",4735,3926,809,0.829144667370644,0.170855332629356
"47149041202","Census Tract 412.02, Rutherford County, Tennessee",3784,3140,644,0.829809725158562,0.170190274841438
"47149041301","Census Tract 413.01, Rutherford County, Tennessee",5266,4712,554,0.89479680972275,0.10520319027725
"47149041302","Census Tract 413.02, Rutherford County, Tennessee",5519,5033,486,0.911940568943649,0.0880594310563508
"47149041401","Census Tract 414.01, Rutherford County, Tennessee",4004,2788,1216,0.696303696303696,0.303696303696304
"47149041402","Census Tract 414.02, Rutherford County, Tennessee",5329,4051,1278,0.760180146368925,0.239819853631075
"47149041403","Census Tract 414.03, Rutherford County, Tennessee",6943,4987,1956,0.718277401699553,0.281722598300447
"47149041500","Census Tract 415, Rutherford County, Tennessee",3213,2367,846,0.736694677871149,0.263305322128851
"47149041600","Census Tract 416, Rutherford County, Tennessee",6308,4598,1710,0.728915662650602,0.271084337349398
"47149041700","Census Tract 417, Rutherford County, Tennessee",5432,4687,745,0.862849779086893,0.137150220913107
"47149041800","Census Tract 418, Rutherford County, Tennessee",4281,3024,1257,0.706377014716188,0.293622985283812
"47149041900","Census Tract 419, Rutherford County, Tennessee",3539,1797,1742,0.507770556654422,0.492229443345578
"47149042000","Census Tract 420, Rutherford County, Tennessee",5442,3976,1466,0.730613744946711,0.269386255053289
"47149042100","Census Tract 421, Rutherford County, Tennessee",8541,5351,3190,0.626507434726613,0.373492565273387
"47149042200","Census Tract 422, Rutherford County, Tennessee",5408,4766,642,0.881286982248521,0.118713017751479
"47149042300","Census Tract 423.00, Rutherford County, Tennessee",6471,4724,1747,0.730026271055478,0.269973728944522
"47151975000","Census Tract 9750, Scott County, Tennessee",4208,4135,73,0.982652091254753,0.0173479087452472
"47151975100","Census Tract 9751, Scott County, Tennessee",6545,6345,200,0.969442322383499,0.0305576776165012
"47151975200","Census Tract 9752, Scott County, Tennessee",5764,5701,63,0.989070090215128,0.0109299097848716
"47151975300","Census Tract 9753, Scott County, Tennessee",2964,2964,0,1,0
"47151975400","Census Tract 9754, Scott County, Tennessee",2690,2668,22,0.99182156133829,0.00817843866171009
"47153060101","Census Tract 601.01, Sequatchie County, Tennessee",7722,6632,1090,0.858844858844859,0.141155141155141
"47153060102","Census Tract 601.02, Sequatchie County, Tennessee",1825,1772,53,0.970958904109589,0.0290410958904109
"47153060200","Census Tract 602, Sequatchie County, Tennessee",4267,4157,110,0.974220764002812,0.0257792359971877
"47155080101","Census Tract 801.01, Sevier County, Tennessee",4141,3794,347,0.916203815503502,0.0837961844964984
"47155080102","Census Tract 801.02, Sevier County, Tennessee",6786,6494,292,0.956970232832302,0.0430297671676982
"47155080201","Census Tract 802.01, Sevier County, Tennessee",7482,7207,275,0.963245121625234,0.0367548783747661
"47155080202","Census Tract 802.02, Sevier County, Tennessee",4994,4759,235,0.952943532238686,0.0470564677613136
"47155080300","Census Tract 803, Sevier County, Tennessee",4910,4746,164,0.966598778004073,0.0334012219959267
"47155080400","Census Tract 804, Sevier County, Tennessee",6562,6212,350,0.94666260286498,0.0533373971350198
"47155080500","Census Tract 805, Sevier County, Tennessee",5491,5352,139,0.974685849572027,0.025314150427973
"47155080601","Census Tract 806.01, Sevier County, Tennessee",3857,3820,37,0.990407052113041,0.00959294788695875
"47155080602","Census Tract 806.02, Sevier County, Tennessee",9004,8685,319,0.964571301643714,0.0354286983562861
"47155080700","Census Tract 807.00, Sevier County, Tennessee",6805,6759,46,0.993240264511389,0.00675973548861131
"47155080801","Census Tract 808.01, Sevier County, Tennessee",2561,2072,489,0.809058961343225,0.190941038656775
"47155080802","Census Tract 808.02, Sevier County, Tennessee",6242,5922,320,0.948734380006408,0.0512656199935918
"47155080901","Census Tract 809.01, Sevier County, Tennessee",3106,3073,33,0.989375402446877,0.0106245975531229
"47155080902","Census Tract 809.02, Sevier County, Tennessee",4284,4157,127,0.970354808590103,0.0296451914098973
"47155081000","Census Tract 810, Sevier County, Tennessee",6197,5982,215,0.965305793125706,0.034694206874294
"47155081101","Census Tract 811.01, Sevier County, Tennessee",1457,1362,95,0.934797529169526,0.0652024708304736
"47155081102","Census Tract 811.02, Sevier County, Tennessee",3628,3434,194,0.946527012127894,0.0534729878721059
"47157000100","Census Tract 1, Shelby County, Tennessee",5409,3929,1480,0.72638195599926,0.27361804400074
"47157000300","Census Tract 3, Shelby County, Tennessee",1298,19,1279,0.0146379044684129,0.985362095531587
"47157000400","Census Tract 4, Shelby County, Tennessee",1471,140,1331,0.0951733514615908,0.904826648538409
"47157000600","Census Tract 6, Shelby County, Tennessee",2932,24,2908,0.00818553888130969,0.99181446111869
"47157000700","Census Tract 7, Shelby County, Tennessee",4588,580,4008,0.126416739319965,0.873583260680035
"47157000800","Census Tract 8, Shelby County, Tennessee",2564,24,2540,0.0093603744149766,0.990639625585023
"47157000900","Census Tract 9, Shelby County, Tennessee",3080,9,3071,0.00292207792207792,0.997077922077922
"47157001100","Census Tract 11, Shelby County, Tennessee",3794,1277,2517,0.336584080126516,0.663415919873484
"47157001200","Census Tract 12, Shelby County, Tennessee",3582,2341,1241,0.653545505304299,0.346454494695701
"47157001300","Census Tract 13, Shelby County, Tennessee",3445,809,2636,0.234833091436865,0.765166908563135
"47157001400","Census Tract 14, Shelby County, Tennessee",1517,147,1370,0.0969017798286091,0.903098220171391
"47157001500","Census Tract 15, Shelby County, Tennessee",1753,198,1555,0.112949229891614,0.887050770108386
"47157001600","Census Tract 16, Shelby County, Tennessee",3431,2881,550,0.839696881375692,0.160303118624308
"47157001700","Census Tract 17, Shelby County, Tennessee",3340,1448,1892,0.433532934131737,0.566467065868263
"47157001900","Census Tract 19, Shelby County, Tennessee",1868,33,1835,0.0176659528907923,0.982334047109208
"47157002000","Census Tract 20, Shelby County, Tennessee",1425,123,1302,0.0863157894736842,0.913684210526316
"47157002100","Census Tract 21, Shelby County, Tennessee",826,46,780,0.0556900726392252,0.944309927360775
"47157002400","Census Tract 24, Shelby County, Tennessee",1800,323,1477,0.179444444444444,0.820555555555556
"47157002500","Census Tract 25, Shelby County, Tennessee",3874,1470,2404,0.379452762003098,0.620547237996902
"47157002600","Census Tract 26, Shelby County, Tennessee",2229,1981,248,0.888739344997757,0.111260655002243
"47157002700","Census Tract 27, Shelby County, Tennessee",2711,715,1996,0.263740317226116,0.736259682773884
"47157002800","Census Tract 28, Shelby County, Tennessee",4106,493,3613,0.120068192888456,0.879931807111544
"47157002900","Census Tract 29, Shelby County, Tennessee",4442,3960,482,0.891490319675822,0.108509680324178
"47157003000","Census Tract 30, Shelby County, Tennessee",2922,1019,1903,0.348733744010951,0.651266255989049
"47157003100","Census Tract 31, Shelby County, Tennessee",3676,2883,793,0.784276387377584,0.215723612622416
"47157003200","Census Tract 32, Shelby County, Tennessee",3651,2751,900,0.753492193919474,0.246507806080526
"47157003300","Census Tract 33, Shelby County, Tennessee",2440,2383,57,0.976639344262295,0.023360655737705
"47157003400","Census Tract 34, Shelby County, Tennessee",2057,1239,818,0.602333495381624,0.397666504618376
"47157003500","Census Tract 35, Shelby County, Tennessee",2891,2349,542,0.812521618817018,0.187478381182982
"47157003600","Census Tract 36, Shelby County, Tennessee",1910,920,990,0.481675392670157,0.518324607329843
"47157003700","Census Tract 37, Shelby County, Tennessee",1285,400,885,0.311284046692607,0.688715953307393
"47157003800","Census Tract 38, Shelby County, Tennessee",1029,275,754,0.267249757045675,0.732750242954325
"47157003900","Census Tract 39, Shelby County, Tennessee",1497,226,1271,0.150968603874415,0.849031396125585
"47157004200","Census Tract 42, Shelby County, Tennessee",1961,1329,632,0.677715451300357,0.322284548699643
"47157004300","Census Tract 43, Shelby County, Tennessee",1250,698,552,0.5584,0.4416
"47157004600","Census Tract 46, Shelby County, Tennessee",832,82,750,0.0985576923076923,0.901442307692308
"47157005500","Census Tract 55, Shelby County, Tennessee",3623,21,3602,0.0057963014076732,0.994203698592327
"47157005800","Census Tract 58, Shelby County, Tennessee",1224,9,1215,0.00735294117647059,0.992647058823529
"47157005900","Census Tract 59, Shelby County, Tennessee",3157,25,3132,0.00791891035793475,0.992081089642065
"47157006000","Census Tract 60, Shelby County, Tennessee",2043,20,2023,0.00978952520802741,0.990210474791973
"47157006200","Census Tract 62, Shelby County, Tennessee",2732,55,2677,0.0201317715959004,0.9798682284041
"47157006300","Census Tract 63, Shelby County, Tennessee",2161,1481,680,0.68533086534012,0.31466913465988
"47157006400","Census Tract 64, Shelby County, Tennessee",1321,28,1293,0.0211960635881908,0.978803936411809
"47157006600","Census Tract 66, Shelby County, Tennessee",2132,1178,954,0.552532833020638,0.447467166979362
"47157006700","Census Tract 67, Shelby County, Tennessee",4001,20,3981,0.00499875031242189,0.995001249687578
"47157006800","Census Tract 68, Shelby County, Tennessee",3058,58,3000,0.0189666448659254,0.981033355134075
"47157006900","Census Tract 69, Shelby County, Tennessee",3528,59,3469,0.0167233560090703,0.98327664399093
"47157007000","Census Tract 70, Shelby County, Tennessee",3332,670,2662,0.201080432172869,0.798919567827131
"47157007100","Census Tract 71, Shelby County, Tennessee",2414,1737,677,0.719552609776305,0.280447390223695
"47157007200","Census Tract 72, Shelby County, Tennessee",2438,2202,236,0.903199343724364,0.0968006562756357
"47157007300","Census Tract 73, Shelby County, Tennessee",4681,2840,1841,0.606707968382824,0.393292031617176
"47157007400","Census Tract 74, Shelby County, Tennessee",2974,2285,689,0.768325487558843,0.231674512441157
"47157007500","Census Tract 75, Shelby County, Tennessee",1490,80,1410,0.0536912751677852,0.946308724832215
"47157007810","Census Tract 78.10, Shelby County, Tennessee",3100,35,3065,0.0112903225806452,0.988709677419355
"47157007821","Census Tract 78.21, Shelby County, Tennessee",6969,96,6873,0.0137752905725355,0.986224709427465
"47157007822","Census Tract 78.22, Shelby County, Tennessee",1594,54,1540,0.0338770388958595,0.966122961104141
"47157007900","Census Tract 79, Shelby County, Tennessee",5809,124,5685,0.0213461869512825,0.978653813048717
"47157008000","Census Tract 80, Shelby County, Tennessee",4881,1306,3575,0.267568121286622,0.732431878713378
"47157008110","Census Tract 81.10, Shelby County, Tennessee",3389,488,2901,0.143995278843317,0.856004721156683
"47157008120","Census Tract 81.20, Shelby County, Tennessee",4865,248,4617,0.0509763617677287,0.949023638232271
"47157008200","Census Tract 82, Shelby County, Tennessee",5634,552,5082,0.0979765708200213,0.902023429179979
"47157008500","Census Tract 85, Shelby County, Tennessee",4182,3986,196,0.953132472501196,0.0468675274988044
"47157008600","Census Tract 86, Shelby County, Tennessee",6286,4592,1694,0.730512249443207,0.269487750556793
"47157008700","Census Tract 87, Shelby County, Tennessee",4061,3269,792,0.804974144299434,0.195025855700566
"47157008800","Census Tract 88, Shelby County, Tennessee",6727,4484,2243,0.666567563549874,0.333432436450126
"47157008900","Census Tract 89, Shelby County, Tennessee",4459,2540,1919,0.569634447185468,0.430365552814532
"47157009100","Census Tract 91, Shelby County, Tennessee",2379,1890,489,0.794451450189155,0.205548549810845
"47157009200","Census Tract 92, Shelby County, Tennessee",7026,6417,609,0.9133219470538,0.0866780529461998
"47157009300","Census Tract 93, Shelby County, Tennessee",4437,3729,708,0.840432724814064,0.159567275185936
"47157009400","Census Tract 94, Shelby County, Tennessee",3165,2994,171,0.945971563981043,0.0540284360189573
"47157009500","Census Tract 95, Shelby County, Tennessee",6260,5511,749,0.88035143769968,0.11964856230032
"47157009600","Census Tract 96, Shelby County, Tennessee",5100,4677,423,0.917058823529412,0.0829411764705882
"47157009700","Census Tract 97, Shelby County, Tennessee",3638,1402,2236,0.385376580538758,0.614623419461242
"47157009800","Census Tract 98, Shelby County, Tennessee",3037,2501,536,0.8235100428054,0.1764899571946
"47157009901","Census Tract 99.01, Shelby County, Tennessee",3997,2064,1933,0.516387290467851,0.483612709532149
"47157009902","Census Tract 99.02, Shelby County, Tennessee",3180,672,2508,0.211320754716981,0.788679245283019
"47157010000","Census Tract 100, Shelby County, Tennessee",8364,637,7727,0.0761597321855571,0.923840267814443
"47157010110","Census Tract 101.10, Shelby County, Tennessee",7177,613,6564,0.0854117319214156,0.914588268078584
"47157010120","Census Tract 101.20, Shelby County, Tennessee",6567,657,5910,0.100045682960256,0.899954317039744
"47157010210","Census Tract 102.10, Shelby County, Tennessee",5491,391,5100,0.0712074303405573,0.928792569659443
"47157010220","Census Tract 102.20, Shelby County, Tennessee",7671,1073,6598,0.139877460565767,0.860122539434233
"47157010500","Census Tract 105, Shelby County, Tennessee",2969,361,2608,0.121589760862243,0.878410239137757
"47157010610","Census Tract 106.10, Shelby County, Tennessee",6436,929,5507,0.144344313238036,0.855655686761964
"47157010620","Census Tract 106.20, Shelby County, Tennessee",3549,290,3259,0.0817131586362356,0.918286841363764
"47157010630","Census Tract 106.30, Shelby County, Tennessee",3477,305,3172,0.087719298245614,0.912280701754386
"47157010710","Census Tract 107.10, Shelby County, Tennessee",4842,1197,3645,0.247211895910781,0.752788104089219
"47157010720","Census Tract 107.20, Shelby County, Tennessee",3495,626,2869,0.179113018597997,0.820886981402003
"47157010810","Census Tract 108.10, Shelby County, Tennessee",5393,576,4817,0.106805117745225,0.893194882254775
"47157010820","Census Tract 108.20, Shelby County, Tennessee",4395,655,3740,0.149032992036405,0.850967007963595
"47157011010","Census Tract 110.10, Shelby County, Tennessee",3823,1527,2296,0.399424535704944,0.600575464295056
"47157011020","Census Tract 110.20, Shelby County, Tennessee",1712,198,1514,0.115654205607477,0.884345794392523
"47157011200","Census Tract 112, Shelby County, Tennessee",2008,10,1998,0.0049800796812749,0.995019920318725
"47157011300","Census Tract 113, Shelby County, Tennessee",1736,164,1572,0.0944700460829493,0.905529953917051
"47157011400","Census Tract 114, Shelby County, Tennessee",5858,594,5264,0.101399795151929,0.898600204848071
"47157011500","Census Tract 115, Shelby County, Tennessee",2640,141,2499,0.0534090909090909,0.946590909090909
"47157011600","Census Tract 116, Shelby County, Tennessee",2857,146,2711,0.0511025551277564,0.948897444872244
"47157011700","Census Tract 117, Shelby County, Tennessee",1881,59,1822,0.0313662945241893,0.968633705475811
"47157011800","Census Tract 118, Shelby County, Tennessee",5458,2272,3186,0.416269695859289,0.583730304140711
"47157020101","Census Tract 201.01, Shelby County, Tennessee",6730,2179,4551,0.323774145616642,0.676225854383358
"47157020102","Census Tract 201.02, Shelby County, Tennessee",2986,2716,270,0.909578030810449,0.0904219691895513
"47157020210","Census Tract 202.10, Shelby County, Tennessee",5603,3656,1947,0.652507585222202,0.347492414777798
"47157020221","Census Tract 202.21, Shelby County, Tennessee",2506,1892,614,0.754988028731046,0.245011971268954
"47157020222","Census Tract 202.22, Shelby County, Tennessee",3229,1645,1584,0.50944564880768,0.49055435119232
"47157020300","Census Tract 203, Shelby County, Tennessee",5247,4128,1119,0.786735277301315,0.213264722698685
"47157020400","Census Tract 204, Shelby County, Tennessee",1611,788,823,0.489137181874612,0.510862818125388
"47157020511","Census Tract 205.11, Shelby County, Tennessee",2252,423,1829,0.187833037300178,0.812166962699822
"47157020512","Census Tract 205.12, Shelby County, Tennessee",5042,1033,4009,0.204879016263388,0.795120983736612
"47157020521","Census Tract 205.21, Shelby County, Tennessee",3666,292,3374,0.0796508456082924,0.920349154391708
"47157020523","Census Tract 205.23, Shelby County, Tennessee",3341,304,3037,0.0909907213409159,0.909009278659084
"47157020524","Census Tract 205.24, Shelby County, Tennessee",4566,514,4052,0.112571178274201,0.887428821725799
"47157020531","Census Tract 205.31, Shelby County, Tennessee",5363,2318,3045,0.432220771955995,0.567779228044005
"47157020532","Census Tract 205.32, Shelby County, Tennessee",5961,1127,4834,0.18906223787955,0.81093776212045
"47157020541","Census Tract 205.41, Shelby County, Tennessee",4911,1405,3506,0.286092445530442,0.713907554469558
"47157020542","Census Tract 205.42, Shelby County, Tennessee",5105,1138,3967,0.222918707149853,0.777081292850147
"47157020610","Census Tract 206.10, Shelby County, Tennessee",4501,1592,2909,0.353699177960453,0.646300822039547
"47157020621","Census Tract 206.21, Shelby County, Tennessee",7405,3363,4042,0.454152599594868,0.545847400405132
"47157020622","Census Tract 206.22, Shelby County, Tennessee",4236,3311,925,0.781633616619452,0.218366383380548
"47157020632","Census Tract 206.32, Shelby County, Tennessee",6367,5570,797,0.874823307680226,0.125176692319774
"47157020633","Census Tract 206.33, Shelby County, Tennessee",2926,2607,319,0.890977443609023,0.109022556390977
"47157020634","Census Tract 206.34, Shelby County, Tennessee",3104,2651,453,0.854059278350515,0.145940721649485
"47157020635","Census Tract 206.35, Shelby County, Tennessee",3015,2685,330,0.890547263681592,0.109452736318408
"47157020642","Census Tract 206.42, Shelby County, Tennessee",7493,5608,1885,0.748431869745095,0.251568130254905
"47157020643","Census Tract 206.43, Shelby County, Tennessee",7758,5921,1837,0.763212168084558,0.236787831915442
"47157020644","Census Tract 206.44, Shelby County, Tennessee",9716,4809,4907,0.494956772334294,0.505043227665706
"47157020651","Census Tract 206.51, Shelby County, Tennessee",7147,4676,2471,0.654260528893242,0.345739471106758
"47157020652","Census Tract 206.52, Shelby County, Tennessee",5963,5240,723,0.878752305886299,0.121247694113701
"47157020700","Census Tract 207, Shelby County, Tennessee",2476,2059,417,0.831583198707593,0.168416801292407
"47157020810","Census Tract 208.10, Shelby County, Tennessee",3011,2261,750,0.750913317834606,0.249086682165394
"47157020820","Census Tract 208.20, Shelby County, Tennessee",6880,5790,1090,0.841569767441861,0.158430232558139
"47157020831","Census Tract 208.31, Shelby County, Tennessee",4063,3505,558,0.862663056854541,0.137336943145459
"47157020832","Census Tract 208.32, Shelby County, Tennessee",7746,6412,1334,0.827782081074103,0.172217918925897
"47157020900","Census Tract 209, Shelby County, Tennessee",8440,7124,1316,0.844075829383886,0.155924170616114
"47157021010","Census Tract 210.10, Shelby County, Tennessee",12930,7438,5492,0.575251353441609,0.424748646558391
"47157021020","Census Tract 210.20, Shelby County, Tennessee",5710,3967,1743,0.694746059544659,0.305253940455341
"47157021111","Census Tract 211.11, Shelby County, Tennessee",3748,1863,1885,0.497065101387407,0.502934898612593
"47157021112","Census Tract 211.12, Shelby County, Tennessee",7055,4864,2191,0.689440113394756,0.310559886605244
"47157021113","Census Tract 211.13, Shelby County, Tennessee",3856,2339,1517,0.606587136929461,0.393412863070539
"47157021121","Census Tract 211.21, Shelby County, Tennessee",4250,2665,1585,0.627058823529412,0.372941176470588
"47157021122","Census Tract 211.22, Shelby County, Tennessee",5572,2485,3087,0.445979899497487,0.554020100502512
"47157021124","Census Tract 211.24, Shelby County, Tennessee",7261,3863,3398,0.532020382867374,0.467979617132626
"47157021125","Census Tract 211.25, Shelby County, Tennessee",4061,2964,1097,0.729869490273332,0.270130509726668
"47157021126","Census Tract 211.26, Shelby County, Tennessee",4015,2830,1185,0.704856787048568,0.295143212951432
"47157021135","Census Tract 211.35, Shelby County, Tennessee",6220,3974,2246,0.638906752411576,0.361093247588424
"47157021136","Census Tract 211.36, Shelby County, Tennessee",5219,3565,1654,0.68308105000958,0.31691894999042
"47157021137","Census Tract 211.37, Shelby County, Tennessee",8455,5562,2893,0.657835600236546,0.342164399763454
"47157021138","Census Tract 211.38, Shelby County, Tennessee",3048,1741,1307,0.571194225721785,0.428805774278215
"47157021139","Census Tract 211.39, Shelby County, Tennessee",4321,3750,571,0.867854663272391,0.132145336727609
"47157021140","Census Tract 211.40, Shelby County, Tennessee",5019,3706,1313,0.738394102410839,0.261605897589161
"47157021141","Census Tract 211.41, Shelby County, Tennessee",6554,3935,2619,0.600396704302716,0.399603295697284
"47157021142","Census Tract 211.42, Shelby County, Tennessee",3422,2889,533,0.844243132670953,0.155756867329047
"47157021200","Census Tract 212, Shelby County, Tennessee",3505,811,2694,0.231383737517832,0.768616262482168
"47157021311","Census Tract 213.11, Shelby County, Tennessee",4544,4248,296,0.934859154929577,0.0651408450704225
"47157021312","Census Tract 213.12, Shelby County, Tennessee",2218,1897,321,0.855275022542831,0.144724977457169
"47157021320","Census Tract 213.20, Shelby County, Tennessee",6330,4199,2131,0.663349131121643,0.336650868878357
"47157021331","Census Tract 213.31, Shelby County, Tennessee",3447,2532,915,0.734551784160139,0.265448215839861
"47157021333","Census Tract 213.33, Shelby County, Tennessee",4477,2690,1787,0.600848782666965,0.399151217333035
"47157021334","Census Tract 213.34, Shelby County, Tennessee",4132,1389,2743,0.336156824782188,0.663843175217812
"47157021341","Census Tract 213.41, Shelby County, Tennessee",5250,4764,486,0.907428571428571,0.0925714285714285
"47157021342","Census Tract 213.42, Shelby County, Tennessee",8554,5229,3325,0.611292962356792,0.388707037643208
"47157021351","Census Tract 213.51, Shelby County, Tennessee",3992,3455,537,0.865480961923848,0.134519038076152
"47157021352","Census Tract 213.52, Shelby County, Tennessee",6973,6429,544,0.921984798508533,0.0780152014914671
"47157021353","Census Tract 213.53, Shelby County, Tennessee",9677,8429,1248,0.871034411491165,0.128965588508835
"47157021410","Census Tract 214.10, Shelby County, Tennessee",2736,2465,271,0.900950292397661,0.0990497076023392
"47157021420","Census Tract 214.20, Shelby County, Tennessee",3456,2998,458,0.867476851851852,0.132523148148148
"47157021430","Census Tract 214.30, Shelby County, Tennessee",4102,3547,555,0.864700146270112,0.135299853729888
"47157021510","Census Tract 215.10, Shelby County, Tennessee",7151,2226,4925,0.311285134946161,0.688714865053839
"47157021520","Census Tract 215.20, Shelby County, Tennessee",9276,4905,4371,0.528783958602846,0.471216041397154
"47157021530","Census Tract 215.30, Shelby County, Tennessee",5178,4425,753,0.854577056778679,0.145422943221321
"47157021540","Census Tract 215.40, Shelby County, Tennessee",10581,9587,994,0.906058028541726,0.0939419714582743
"47157021611","Census Tract 216.11, Shelby County, Tennessee",6191,5655,536,0.913422710386044,0.0865772896139557
"47157021612","Census Tract 216.12, Shelby County, Tennessee",4917,4590,327,0.933496034167175,0.0665039658328249
"47157021613","Census Tract 216.13, Shelby County, Tennessee",4463,3870,593,0.867129733363209,0.132870266636791
"47157021620","Census Tract 216.20, Shelby County, Tennessee",2614,1407,1207,0.538255547054323,0.461744452945677
"47157021710","Census Tract 217.10, Shelby County, Tennessee",2222,231,1991,0.103960396039604,0.896039603960396
"47157021721","Census Tract 217.21, Shelby County, Tennessee",4186,389,3797,0.0929288103201147,0.907071189679885
"47157021724","Census Tract 217.24, Shelby County, Tennessee",2133,342,1791,0.160337552742616,0.839662447257384
"47157021725","Census Tract 217.25, Shelby County, Tennessee",3804,585,3219,0.153785488958991,0.84621451104101
"47157021726","Census Tract 217.26, Shelby County, Tennessee",3983,1245,2738,0.312578458448406,0.687421541551594
"47157021731","Census Tract 217.31, Shelby County, Tennessee",3172,330,2842,0.104035308953342,0.895964691046658
"47157021732","Census Tract 217.32, Shelby County, Tennessee",6472,633,5839,0.0978059332509271,0.902194066749073
"47157021741","Census Tract 217.41, Shelby County, Tennessee",7475,1142,6333,0.152775919732441,0.847224080267559
"47157021744","Census Tract 217.44, Shelby County, Tennessee",5691,966,4725,0.169741697416974,0.830258302583026
"47157021745","Census Tract 217.45, Shelby County, Tennessee",6959,1361,5598,0.195574076735163,0.804425923264837
"47157021746","Census Tract 217.46, Shelby County, Tennessee",4166,547,3619,0.131301008161306,0.868698991838694
"47157021747","Census Tract 217.47, Shelby County, Tennessee",4065,472,3593,0.116113161131611,0.883886838868389
"47157021751","Census Tract 217.51, Shelby County, Tennessee",6348,512,5836,0.0806553245116572,0.919344675488343
"47157021752","Census Tract 217.52, Shelby County, Tennessee",4108,319,3789,0.0776533592989289,0.922346640701071
"47157021753","Census Tract 217.53, Shelby County, Tennessee",3125,440,2685,0.1408,0.8592
"47157021754","Census Tract 217.54, Shelby County, Tennessee",4813,361,4452,0.0750051942655309,0.924994805734469
"47157021900","Census Tract 219, Shelby County, Tennessee",5035,55,4980,0.0109235352532274,0.989076464746773
"47157022022","Census Tract 220.22, Shelby County, Tennessee",4660,76,4584,0.0163090128755365,0.983690987124464
"47157022023","Census Tract 220.23, Shelby County, Tennessee",3311,83,3228,0.0250679553005134,0.974932044699487
"47157022024","Census Tract 220.24, Shelby County, Tennessee",3903,186,3717,0.0476556495003843,0.952344350499616
"47157022111","Census Tract 221.11, Shelby County, Tennessee",5624,170,5454,0.0302275960170697,0.96977240398293
"47157022112","Census Tract 221.12, Shelby County, Tennessee",5664,134,5530,0.0236581920903955,0.976341807909605
"47157022121","Census Tract 221.21, Shelby County, Tennessee",4453,244,4209,0.0547945205479452,0.945205479452055
"47157022122","Census Tract 221.22, Shelby County, Tennessee",3645,181,3464,0.0496570644718793,0.950342935528121
"47157022130","Census Tract 221.30, Shelby County, Tennessee",6265,269,5996,0.0429369513168396,0.95706304868316
"47157022210","Census Tract 222.10, Shelby County, Tennessee",4969,10,4959,0.0020124773596297,0.99798752264037
"47157022321","Census Tract 223.21, Shelby County, Tennessee",3944,87,3857,0.0220588235294118,0.977941176470588
"47157022322","Census Tract 223.22, Shelby County, Tennessee",4244,37,4207,0.0087181903864279,0.991281809613572
"47157022330","Census Tract 223.30, Shelby County, Tennessee",5217,171,5046,0.0327774583093732,0.967222541690627
"47157022410","Census Tract 224.10, Shelby County, Tennessee",6864,513,6351,0.0747377622377622,0.925262237762238
"47157022500","Census Tract 225, Shelby County, Tennessee",4350,298,4052,0.0685057471264368,0.931494252873563
"47157022600","Census Tract 226, Shelby County, Tennessee",3190,498,2692,0.156112852664577,0.843887147335423
"47157022700","Census Tract 227, Shelby County, Tennessee",7498,201,7297,0.0268071485729528,0.973192851427047
"47157980400","Census Tract 9804, Shelby County, Tennessee",905,146,759,0.161325966850829,0.838674033149171
"47159975000","Census Tract 9750, Smith County, Tennessee",3928,3769,159,0.959521384928717,0.0404786150712831
"47159975100","Census Tract 9751, Smith County, Tennessee",2829,2601,228,0.919406150583245,0.0805938494167551
"47159975200","Census Tract 9752, Smith County, Tennessee",5256,5022,234,0.955479452054795,0.0445205479452054
"47159975300","Census Tract 9753, Smith County, Tennessee",2272,2162,110,0.951584507042254,0.0484154929577465
"47159975400","Census Tract 9754, Smith County, Tennessee",4750,4583,167,0.964842105263158,0.0351578947368421
"47161110200","Census Tract 1102, Stewart County, Tennessee",5890,5761,129,0.978098471986418,0.0219015280135824
"47161110600","Census Tract 1106, Stewart County, Tennessee",2721,2487,234,0.914002205071665,0.0859977949283351
"47161110700","Census Tract 1107, Stewart County, Tennessee",4522,4251,271,0.940070765148165,0.0599292348518354
"47163040200","Census Tract 402, Sullivan County, Tennessee",2482,1755,727,0.707091055600322,0.292908944399678
"47163040300","Census Tract 403, Sullivan County, Tennessee",2860,2535,325,0.886363636363636,0.113636363636364
"47163040500","Census Tract 405, Sullivan County, Tennessee",4465,4009,456,0.897872340425532,0.102127659574468
"47163040600","Census Tract 406, Sullivan County, Tennessee",2991,2838,153,0.948846539618857,0.0511534603811434
"47163040700","Census Tract 407, Sullivan County, Tennessee",2697,2578,119,0.955876900259548,0.0441230997404524
"47163040800","Census Tract 408, Sullivan County, Tennessee",3688,3404,284,0.922993492407809,0.0770065075921909
"47163040900","Census Tract 409, Sullivan County, Tennessee",3249,2927,322,0.900892582333025,0.0991074176669745
"47163041000","Census Tract 410, Sullivan County, Tennessee",4193,4014,179,0.957309802051037,0.0426901979489626
"47163041100","Census Tract 411, Sullivan County, Tennessee",2564,2527,37,0.985569422776911,0.0144305772230889
"47163041200","Census Tract 412, Sullivan County, Tennessee",6606,6298,308,0.953375719043294,0.046624280956706
"47163041300","Census Tract 413, Sullivan County, Tennessee",4235,4176,59,0.986068476977568,0.0139315230224322
"47163041400","Census Tract 414, Sullivan County, Tennessee",5719,5653,66,0.988459520895261,0.0115404791047385
"47163041500","Census Tract 415, Sullivan County, Tennessee",2546,2408,138,0.945797329143755,0.0542026708562451
"47163041600","Census Tract 416, Sullivan County, Tennessee",2518,2433,85,0.966243050039714,0.0337569499602859
"47163041700","Census Tract 417, Sullivan County, Tennessee",3391,3370,21,0.993807136537894,0.00619286346210557
"47163041800","Census Tract 418, Sullivan County, Tennessee",4790,4160,630,0.868475991649269,0.131524008350731
"47163041900","Census Tract 419, Sullivan County, Tennessee",3213,3213,0,1,0
"47163042000","Census Tract 420, Sullivan County, Tennessee",3522,3455,67,0.980976717773992,0.0190232822260079
"47163042100","Census Tract 421, Sullivan County, Tennessee",5377,5017,360,0.933048168123489,0.0669518318765111
"47163042200","Census Tract 422, Sullivan County, Tennessee",3309,3309,0,1,0
"47163042300","Census Tract 423, Sullivan County, Tennessee",6622,6427,195,0.970552703110843,0.0294472968891574
"47163042400","Census Tract 424, Sullivan County, Tennessee",3252,3139,113,0.965252152521525,0.0347478474784748
"47163042500","Census Tract 425, Sullivan County, Tennessee",3441,3431,10,0.99709386806161,0.00290613193838996
"47163042600","Census Tract 426, Sullivan County, Tennessee",4500,4241,259,0.942444444444444,0.0575555555555556
"47163042701","Census Tract 427.01, Sullivan County, Tennessee",5504,5123,381,0.93077761627907,0.0692223837209303
"47163042702","Census Tract 427.02, Sullivan County, Tennessee",2055,1924,131,0.93625304136253,0.0637469586374696
"47163042801","Census Tract 428.01, Sullivan County, Tennessee",2456,2399,57,0.976791530944625,0.0232084690553745
"47163042802","Census Tract 428.02, Sullivan County, Tennessee",4391,4052,339,0.922796629469369,0.0772033705306309
"47163042900","Census Tract 429, Sullivan County, Tennessee",4142,3997,145,0.964992757122163,0.0350072428778367
"47163043000","Census Tract 430, Sullivan County, Tennessee",4552,4431,121,0.973418277680141,0.0265817223198594
"47163043100","Census Tract 431, Sullivan County, Tennessee",3483,3243,240,0.931093884582257,0.0689061154177433
"47163043201","Census Tract 432.01, Sullivan County, Tennessee",4015,3974,41,0.989788293897883,0.0102117061021171
"47163043202","Census Tract 432.02, Sullivan County, Tennessee",4869,4810,59,0.987882522078456,0.0121174779215445
"47163043301","Census Tract 433.01, Sullivan County, Tennessee",5016,4987,29,0.994218500797448,0.00578149920255189
"47163043302","Census Tract 433.02, Sullivan County, Tennessee",5297,5208,89,0.983198036624504,0.0168019633754956
"47163043401","Census Tract 434.01, Sullivan County, Tennessee",4944,4883,61,0.987661812297735,0.0123381877022654
"47163043402","Census Tract 434.02, Sullivan County, Tennessee",4509,4332,177,0.960745176314039,0.0392548236859614
"47163043500","Census Tract 435, Sullivan County, Tennessee",3409,3344,65,0.98093282487533,0.01906717512467
"47163043600","Census Tract 436, Sullivan County, Tennessee",4943,4790,153,0.969047137365972,0.030952862634028
"47165020101","Census Tract 201.01, Sumner County, Tennessee",3195,3116,79,0.975273865414711,0.0247261345852895
"47165020102","Census Tract 201.02, Sumner County, Tennessee",5460,5378,82,0.984981684981685,0.015018315018315
"47165020203","Census Tract 202.03, Sumner County, Tennessee",2036,1947,89,0.956286836935167,0.043713163064833
"47165020204","Census Tract 202.04, Sumner County, Tennessee",2859,2669,190,0.933543196922001,0.0664568030779993
"47165020205","Census Tract 202.05, Sumner County, Tennessee",2759,2515,244,0.911562160202972,0.0884378397970279
"47165020206","Census Tract 202.06, Sumner County, Tennessee",1301,1276,25,0.980784012298232,0.0192159877017679
"47165020207","Census Tract 202.07, Sumner County, Tennessee",1473,1362,111,0.924643584521385,0.075356415478615
"47165020208","Census Tract 202.08, Sumner County, Tennessee",2097,1952,145,0.930853600381497,0.0691463996185027
"47165020209","Census Tract 202.09, Sumner County, Tennessee",1761,1761,0,1,0
"47165020300","Census Tract 203, Sumner County, Tennessee",4890,4509,381,0.922085889570552,0.0779141104294478
"47165020403","Census Tract 204.03, Sumner County, Tennessee",1976,1974,2,0.998987854251012,0.00101214574898789
"47165020404","Census Tract 204.04, Sumner County, Tennessee",1895,1853,42,0.977836411609499,0.0221635883905014
"47165020405","Census Tract 204.05, Sumner County, Tennessee",1878,1838,40,0.978700745473908,0.0212992545260916
"47165020406","Census Tract 204.06, Sumner County, Tennessee",3282,3219,63,0.980804387568556,0.0191956124314442
"47165020407","Census Tract 204.07, Sumner County, Tennessee",4062,3842,220,0.945839487936977,0.0541605120630232
"47165020501","Census Tract 205.01, Sumner County, Tennessee",3672,3516,156,0.957516339869281,0.0424836601307189
"47165020502","Census Tract 205.02, Sumner County, Tennessee",3132,3004,128,0.959131545338442,0.0408684546615581
"47165020503","Census Tract 205.03, Sumner County, Tennessee",1590,1563,27,0.983018867924528,0.0169811320754717
"47165020601","Census Tract 206.01, Sumner County, Tennessee",3723,3672,51,0.986301369863014,0.0136986301369864
"47165020602","Census Tract 206.02, Sumner County, Tennessee",3873,3610,263,0.932093983991738,0.0679060160082623
"47165020603","Census Tract 206.03, Sumner County, Tennessee",2991,2918,73,0.97559344700769,0.0244065529923103
"47165020700","Census Tract 207, Sumner County, Tennessee",5459,4264,1195,0.781095438725041,0.218904561274959
"47165020800","Census Tract 208, Sumner County, Tennessee",6377,3792,2585,0.594636976634781,0.405363023365219
"47165020901","Census Tract 209.01, Sumner County, Tennessee",1244,1184,60,0.951768488745981,0.0482315112540193
"47165020902","Census Tract 209.02, Sumner County, Tennessee",6796,5629,1167,0.828281341965862,0.171718658034138
"47165020903","Census Tract 209.03, Sumner County, Tennessee",4104,3697,407,0.900828460038986,0.0991715399610137
"47165021002","Census Tract 210.02, Sumner County, Tennessee",6390,5274,1116,0.825352112676056,0.174647887323944
"47165021004","Census Tract 210.04, Sumner County, Tennessee",3840,3540,300,0.921875,0.078125
"47165021005","Census Tract 210.05, Sumner County, Tennessee",5587,4947,640,0.885448362269554,0.114551637730446
"47165021006","Census Tract 210.06, Sumner County, Tennessee",3163,2689,474,0.850142269996838,0.149857730003162
"47165021007","Census Tract 210.07, Sumner County, Tennessee",1334,1257,77,0.942278860569715,0.0577211394302849
"47165021008","Census Tract 210.08, Sumner County, Tennessee",3693,3368,325,0.911995667479014,0.0880043325209856
"47165021009","Census Tract 210.09, Sumner County, Tennessee",4539,4019,520,0.885437320995814,0.114562679004186
"47165021103","Census Tract 211.03, Sumner County, Tennessee",5852,4952,900,0.846206425153794,0.153793574846206
"47165021104","Census Tract 211.04, Sumner County, Tennessee",1944,1621,323,0.833847736625514,0.166152263374486
"47165021105","Census Tract 211.05, Sumner County, Tennessee",6734,5743,991,0.852836352836353,0.147163647163647
"47165021106","Census Tract 211.06, Sumner County, Tennessee",3706,3118,588,0.84133837021047,0.15866162978953
"47165021107","Census Tract 211.07, Sumner County, Tennessee",4217,3852,365,0.91344557742471,0.0865544225752904
"47165021201","Census Tract 212.01, Sumner County, Tennessee",6277,6050,227,0.963836227497212,0.0361637725027879
"47165021203","Census Tract 212.03, Sumner County, Tennessee",4554,4439,115,0.974747474747475,0.0252525252525253
"47165021204","Census Tract 212.04, Sumner County, Tennessee",7549,6478,1071,0.858126904225725,0.141873095774275
"47165021205","Census Tract 212.05, Sumner County, Tennessee",2328,2201,127,0.945446735395189,0.054553264604811
"47167040100","Census Tract 401, Tipton County, Tennessee",4539,4035,504,0.888962326503635,0.111037673496365
"47167040200","Census Tract 402, Tipton County, Tennessee",2288,2096,192,0.916083916083916,0.083916083916084
"47167040302","Census Tract 403.02, Tipton County, Tennessee",8636,7419,1217,0.859078276980083,0.140921723019917
"47167040303","Census Tract 403.03, Tipton County, Tennessee",5672,4636,1036,0.817348377997179,0.182651622002821
"47167040304","Census Tract 403.04, Tipton County, Tennessee",6505,5965,540,0.916986933128363,0.0830130668716372
"47167040400","Census Tract 404, Tipton County, Tennessee",3473,3270,203,0.941549093003167,0.0584509069968328
"47167040500","Census Tract 405, Tipton County, Tennessee",5833,5122,711,0.87810732041831,0.12189267958169
"47167040601","Census Tract 406.01, Tipton County, Tennessee",4941,2963,1978,0.599676178911152,0.400323821088848
"47167040602","Census Tract 406.02, Tipton County, Tennessee",3191,2608,583,0.817298652460044,0.182701347539956
"47167040700","Census Tract 407, Tipton County, Tennessee",5478,2177,3301,0.397407813070464,0.602592186929536
"47167040800","Census Tract 408, Tipton County, Tennessee",4279,3730,549,0.871698995092311,0.128301004907689
"47167040900","Census Tract 409, Tipton County, Tennessee",1600,1292,308,0.8075,0.1925
"47167041000","Census Tract 410, Tipton County, Tennessee",3254,1439,1815,0.442224953902889,0.557775046097111
"47169090100","Census Tract 901, Trousdale County, Tennessee",5137,4604,533,0.896242943352151,0.103757056647849
"47169090200","Census Tract 902, Trousdale County, Tennessee",2614,2210,404,0.845447589900536,0.154552410099464
"47171080100","Census Tract 801, Unicoi County, Tennessee",2732,2722,10,0.996339677891654,0.00366032210834555
"47171080200","Census Tract 802, Unicoi County, Tennessee",6382,6164,218,0.965841429019116,0.0341585709808837
"47171080300","Census Tract 803, Unicoi County, Tennessee",5147,4965,182,0.964639595881096,0.0353604041189042
"47171080400","Census Tract 804, Unicoi County, Tennessee",3996,3938,58,0.985485485485486,0.0145145145145145
"47173040100","Census Tract 401, Union County, Tennessee",6935,6803,132,0.980966113914924,0.0190338860850757
"47173040201","Census Tract 402.01, Union County, Tennessee",3761,3694,67,0.982185588939112,0.0178144110608881
"47173040202","Census Tract 402.02, Union County, Tennessee",6158,5989,169,0.972556024683339,0.0274439753166612
"47173040300","Census Tract 403, Union County, Tennessee",2234,2210,24,0.989256938227395,0.0107430617726052
"47175925000","Census Tract 9250, Van Buren County, Tennessee",2226,2143,83,0.962713387241689,0.0372866127583109
"47175925200","Census Tract 9252, Van Buren County, Tennessee",3277,3129,148,0.954836740921575,0.0451632590784254
"47177930100","Census Tract 9301, Warren County, Tennessee",3787,3657,130,0.965672035912332,0.0343279640876684
"47177930200","Census Tract 9302, Warren County, Tennessee",6697,6502,195,0.970882484694639,0.0291175153053607
"47177930300","Census Tract 9303, Warren County, Tennessee",2672,2568,104,0.961077844311377,0.0389221556886228
"47177930400","Census Tract 9304, Warren County, Tennessee",5823,5292,531,0.908809891808346,0.0911901081916537
"47177930500","Census Tract 9305, Warren County, Tennessee",4685,4373,312,0.933404482390608,0.0665955176093916
"47177930600","Census Tract 9306, Warren County, Tennessee",3632,3301,331,0.90886563876652,0.0911343612334802
"47177930700","Census Tract 9307, Warren County, Tennessee",4671,4405,266,0.943052879469064,0.0569471205309355
"47177930800","Census Tract 9308, Warren County, Tennessee",5757,5369,388,0.932603786694459,0.0673962133055411
"47177930900","Census Tract 9309, Warren County, Tennessee",1815,1717,98,0.946005509641873,0.0539944903581268
"47179060100","Census Tract 601, Washington County, Tennessee",3368,2500,868,0.742280285035629,0.257719714964371
"47179060400","Census Tract 604, Washington County, Tennessee",5823,5656,167,0.971320625107333,0.028679374892667
"47179060501","Census Tract 605.01, Washington County, Tennessee",4555,4105,450,0.901207464324918,0.0987925356750823
"47179060502","Census Tract 605.02, Washington County, Tennessee",5876,5260,616,0.895166780122532,0.104833219877468
"47179060600","Census Tract 606, Washington County, Tennessee",7077,6239,838,0.881588243606048,0.118411756393952
"47179060700","Census Tract 607, Washington County, Tennessee",1504,1232,272,0.819148936170213,0.180851063829787
"47179060800","Census Tract 608, Washington County, Tennessee",2870,2527,343,0.880487804878049,0.119512195121951
"47179060900","Census Tract 609, Washington County, Tennessee",5485,4470,1015,0.814949863263446,0.185050136736554
"47179061000","Census Tract 610, Washington County, Tennessee",2417,1849,568,0.764997931319818,0.235002068680182
"47179061100","Census Tract 611, Washington County, Tennessee",4471,4103,368,0.917691791545516,0.0823082084544845
"47179061200","Census Tract 612, Washington County, Tennessee",2922,2732,190,0.934976043805613,0.0650239561943874
"47179061300","Census Tract 613, Washington County, Tennessee",8089,7357,732,0.909506737544814,0.0904932624551861
"47179061401","Census Tract 614.01, Washington County, Tennessee",4489,4281,208,0.953664513254622,0.0463354867453776
"47179061402","Census Tract 614.02, Washington County, Tennessee",5543,5393,150,0.972938841782428,0.0270611582175717
"47179061500","Census Tract 615, Washington County, Tennessee",6753,6347,406,0.939878572486302,0.0601214275136976
"47179061601","Census Tract 616.01, Washington County, Tennessee",3749,3700,49,0.986929847959456,0.0130701520405442
"47179061602","Census Tract 616.02, Washington County, Tennessee",9583,9473,110,0.988521339872691,0.0114786601273088
"47179061701","Census Tract 617.01, Washington County, Tennessee",5429,5034,395,0.927242586111623,0.0727574138883772
"47179061702","Census Tract 617.02, Washington County, Tennessee",6822,6721,101,0.985194957490472,0.014805042509528
"47179061800","Census Tract 618, Washington County, Tennessee",6973,6973,0,1,0
"47179061901","Census Tract 619.01, Washington County, Tennessee",7569,7407,162,0.978596908442331,0.0214030915576694
"47179061902","Census Tract 619.02, Washington County, Tennessee",4623,4623,0,1,0
"47179062000","Census Tract 620, Washington County, Tennessee",3778,3289,489,0.870566437268396,0.129433562731604
"47181950100","Census Tract 9501, Wayne County, Tennessee",4686,3682,1004,0.785744771660265,0.214255228339735
"47181950200","Census Tract 9502, Wayne County, Tennessee",5017,4888,129,0.974287422762607,0.0257125772373928
"47181950300","Census Tract 9503, Wayne County, Tennessee",3974,3774,200,0.949672873678913,0.050327126321087
"47181950400","Census Tract 9504, Wayne County, Tennessee",3339,3283,56,0.983228511530398,0.0167714884696016
"47183968000","Census Tract 9680, Weakley County, Tennessee",1370,1370,0,1,0
"47183968101","Census Tract 9681.01, Weakley County, Tennessee",3650,2612,1038,0.715616438356164,0.284383561643836
"47183968102","Census Tract 9681.02, Weakley County, Tennessee",2136,1891,245,0.885299625468165,0.114700374531835
"47183968201","Census Tract 9682.01, Weakley County, Tennessee",4437,4204,233,0.947487040793329,0.0525129592066712
"47183968202","Census Tract 9682.02, Weakley County, Tennessee",2071,1535,536,0.741187831965234,0.258812168034766
"47183968203","Census Tract 9682.03, Weakley County, Tennessee",3353,2774,579,0.827318818968088,0.172681181031912
"47183968300","Census Tract 9683, Weakley County, Tennessee",2409,2223,186,0.922789539227895,0.0772104607721046
"47183968400","Census Tract 9684, Weakley County, Tennessee",5248,5085,163,0.968940548780488,0.0310594512195121
"47183968500","Census Tract 9685, Weakley County, Tennessee",4747,4575,172,0.9637665894249,0.0362334105751001
"47183968600","Census Tract 9686, Weakley County, Tennessee",3814,3344,470,0.876769795490299,0.123230204509701
"47183968700","Census Tract 9687, Weakley County, Tennessee",1322,1204,118,0.910741301059002,0.0892586989409985
"47185935000","Census Tract 9350, White County, Tennessee",3880,3796,84,0.978350515463917,0.0216494845360825
"47185935100","Census Tract 9351, White County, Tennessee",5685,5619,66,0.988390501319261,0.0116094986807388
"47185935200","Census Tract 9352, White County, Tennessee",3981,3934,47,0.988193921125345,0.0118060788746546
"47185935300","Census Tract 9353, White County, Tennessee",4670,4316,354,0.924197002141328,0.0758029978586724
"47185935400","Census Tract 9354, White County, Tennessee",3547,3210,337,0.904990132506343,0.0950098674936566
"47185935500","Census Tract 9355, White County, Tennessee",3697,3614,83,0.977549364349473,0.0224506356505274
"47187050101","Census Tract 501.01, Williamson County, Tennessee",6302,5263,1039,0.835131704220882,0.164868295779118
"47187050102","Census Tract 501.02, Williamson County, Tennessee",3564,3361,203,0.94304152637486,0.0569584736251403
"47187050103","Census Tract 501.03, Williamson County, Tennessee",3716,3408,308,0.917115177610334,0.0828848223896663
"47187050203","Census Tract 502.03, Williamson County, Tennessee",5228,4900,328,0.93726090283091,0.0627390971690895
"47187050204","Census Tract 502.04, Williamson County, Tennessee",4581,3850,731,0.84042785418031,0.15957214581969
"47187050205","Census Tract 502.05, Williamson County, Tennessee",3304,3157,147,0.955508474576271,0.0444915254237288
"47187050206","Census Tract 502.06, Williamson County, Tennessee",2901,2792,109,0.96242674939676,0.0375732506032402
"47187050207","Census Tract 502.07, Williamson County, Tennessee",3467,3188,279,0.919526968560715,0.0804730314392846
"47187050208","Census Tract 502.08, Williamson County, Tennessee",5659,4263,1396,0.753313306237851,0.246686693762149
"47187050303","Census Tract 503.03, Williamson County, Tennessee",2870,2785,85,0.970383275261324,0.0296167247386759
"47187050304","Census Tract 503.04, Williamson County, Tennessee",1931,1820,111,0.94251683065769,0.0574831693423097
"47187050305","Census Tract 503.05, Williamson County, Tennessee",2310,2140,170,0.926406926406926,0.0735930735930735
"47187050306","Census Tract 503.06, Williamson County, Tennessee",1532,1322,210,0.862924281984334,0.137075718015666
"47187050307","Census Tract 503.07, Williamson County, Tennessee",3166,2957,209,0.933986102337334,0.0660138976626659
"47187050403","Census Tract 504.03, Williamson County, Tennessee",1963,1951,12,0.993886907794193,0.00611309220580747
"47187050404","Census Tract 504.04, Williamson County, Tennessee",6700,6195,505,0.924626865671642,0.0753731343283582
"47187050405","Census Tract 504.05, Williamson County, Tennessee",2380,2352,28,0.988235294117647,0.0117647058823529
"47187050406","Census Tract 504.06, Williamson County, Tennessee",5347,5053,294,0.945015896764541,0.0549841032354591
"47187050502","Census Tract 505.02, Williamson County, Tennessee",4002,3979,23,0.994252873563218,0.00574712643678166
"47187050503","Census Tract 505.03, Williamson County, Tennessee",4302,4214,88,0.97954439795444,0.0204556020455602
"47187050504","Census Tract 505.04, Williamson County, Tennessee",3677,3558,119,0.967636660320914,0.0323633396790862
"47187050601","Census Tract 506.01, Williamson County, Tennessee",6315,5632,683,0.891844813935075,0.108155186064925
"47187050602","Census Tract 506.02, Williamson County, Tennessee",7861,6857,1004,0.872280880295128,0.127719119704872
"47187050701","Census Tract 507.01, Williamson County, Tennessee",4195,3886,309,0.926340882002384,0.0736591179976163
"47187050702","Census Tract 507.02, Williamson County, Tennessee",4189,4039,150,0.964191931248508,0.035808068751492
"47187050800","Census Tract 508, Williamson County, Tennessee",5558,3966,1592,0.713566030946384,0.286433969053616
"47187050904","Census Tract 509.04, Williamson County, Tennessee",4504,3426,1078,0.760657193605684,0.239342806394316
"47187050905","Census Tract 509.05, Williamson County, Tennessee",5488,5010,478,0.912900874635568,0.0870991253644315
"47187050906","Census Tract 509.06, Williamson County, Tennessee",5349,4992,357,0.933258553000561,0.0667414469994392
"47187050907","Census Tract 509.07, Williamson County, Tennessee",4986,4422,564,0.886883273164862,0.113116726835138
"47187050908","Census Tract 509.08, Williamson County, Tennessee",3343,3158,185,0.944660484594675,0.0553395154053246
"47187050909","Census Tract 509.09, Williamson County, Tennessee",3565,3358,207,0.941935483870968,0.0580645161290323
"47187051001","Census Tract 510.01, Williamson County, Tennessee",4974,4385,589,0.881584238037797,0.118415761962203
"47187051002","Census Tract 510.02, Williamson County, Tennessee",5569,5238,331,0.940563835518046,0.0594361644819537
"47187051100","Census Tract 511.00, Williamson County, Tennessee",5416,4965,451,0.916728212703102,0.0832717872968981
"47187051201","Census Tract 512.01, Williamson County, Tennessee",5113,4750,363,0.929004498337571,0.0709955016624291
"47187051202","Census Tract 512.02, Williamson County, Tennessee",18933,16754,2179,0.884909945597634,0.115090054402366
"47189030101","Census Tract 301.01, Wilson County, Tennessee",7697,7220,477,0.938027803040146,0.0619721969598545
"47189030102","Census Tract 301.02, Wilson County, Tennessee",7098,6592,506,0.928712313327698,0.071287686672302
"47189030202","Census Tract 302.02, Wilson County, Tennessee",4945,4590,355,0.928210313447927,0.0717896865520729
"47189030203","Census Tract 302.03, Wilson County, Tennessee",4153,3643,510,0.87719720683843,0.12280279316157
"47189030204","Census Tract 302.04, Wilson County, Tennessee",5663,5338,325,0.942609924068515,0.057390075931485
"47189030303","Census Tract 303.03, Wilson County, Tennessee",4403,4206,197,0.955257778787191,0.0447422212128095
"47189030304","Census Tract 303.04, Wilson County, Tennessee",6148,5620,528,0.914118412491867,0.0858815875081327
"47189030305","Census Tract 303.05, Wilson County, Tennessee",5441,5272,169,0.968939533174049,0.0310604668259511
"47189030307","Census Tract 303.07, Wilson County, Tennessee",6625,6179,446,0.932679245283019,0.0673207547169812
"47189030308","Census Tract 303.08, Wilson County, Tennessee",4476,3785,691,0.84562109025916,0.15437890974084
"47189030309","Census Tract 303.09, Wilson County, Tennessee",4797,4242,555,0.884302689180738,0.115697310819262
"47189030401","Census Tract 304.01, Wilson County, Tennessee",2157,1925,232,0.892443208159481,0.107556791840519
"47189030402","Census Tract 304.02, Wilson County, Tennessee",3215,2344,871,0.729082426127527,0.270917573872473
"47189030500","Census Tract 305, Wilson County, Tennessee",6352,4817,1535,0.758343828715365,0.241656171284635
"47189030600","Census Tract 306, Wilson County, Tennessee",4429,4020,409,0.907654097990517,0.092345902009483
"47189030700","Census Tract 307, Wilson County, Tennessee",3063,1794,1269,0.585700293829579,0.414299706170421
"47189030800","Census Tract 308, Wilson County, Tennessee",5318,5185,133,0.974990597969161,0.0250094020308387
"47189030901","Census Tract 309.01, Wilson County, Tennessee",8543,7736,807,0.905536696710757,0.0944633032892427
"47189030903","Census Tract 309.03, Wilson County, Tennessee",5508,5141,367,0.933369644153958,0.0666303558460422
"47189030904","Census Tract 309.04, Wilson County, Tennessee",3436,3139,297,0.913562281722934,0.0864377182770664
"47189031000","Census Tract 310, Wilson County, Tennessee",6096,5873,223,0.963418635170604,0.0365813648293963
