"GEOID","GEO.display.label","pop","pop.white","pop.not.white","pct.white","pct.not.white"
40017300201,40017300201,5263,4751,512,0.902717081512445,0.0972829184875547
40017300202,40017300202,4308,3506,802,0.813834726090993,0.186165273909007
40017300300,40017300300,3381,2394,987,0.708074534161491,0.291925465838509
40017300400,40017300400,1127,540,587,0.479148181011535,0.520851818988465
40017300600,40017300600,3201,2607,594,0.814432989690722,0.185567010309278
40017300700,40017300700,6173,4643,1530,0.752146444192451,0.247853555807549
40017300801,40017300801,8021,6963,1058,0.868096247350704,0.131903752649296
40017300901,40017300901,5914,4986,928,0.84308420696652,0.15691579303348
40017300904,40017300904,3643,2951,692,0.810046664836673,0.189953335163327
40017300905,40017300905,4436,3732,704,0.841298467087466,0.158701532912534
40017301003,40017301003,5932,4966,966,0.837154416722859,0.162845583277141
40017301006,40017301006,3210,2461,749,0.766666666666667,0.233333333333333
40017301007,40017301007,5285,3919,1366,0.741532639545885,0.258467360454115
40017301008,40017301008,5942,4210,1732,0.70851565129586,0.29148434870414
40017301100,40017301100,5949,5222,727,0.877794587325601,0.122205412674399
40017301201,40017301201,4042,3550,492,0.878278080158337,0.121721919841663
40017301202,40017301202,2519,2289,230,0.908693926161175,0.0913060738388249
40017301300,40017301300,4483,3947,536,0.880437207227303,0.119562792772697
40017301406,40017301406,4898,4391,507,0.896488362596978,0.103511637403022
40017301407,40017301407,5103,4522,581,0.886145404663923,0.113854595336077
40017301408,40017301408,1921,1742,179,0.906819364914107,0.0931806350858928
40017301409,40017301409,2815,2440,375,0.866785079928952,0.133214920071048
40017301410,40017301410,4579,4018,561,0.877484166848657,0.122515833151343
40027200100,40027200100,578,458,120,0.792387543252595,0.207612456747405
40027200200,40027200200,1786,1435,351,0.803471444568869,0.196528555431131
40027200300,40027200300,3586,2734,852,0.762409369771333,0.237590630228667
40027200400,40027200400,1922,1535,387,0.798647242455775,0.201352757544225
40027200500,40027200500,3797,3237,560,0.852515143534369,0.147484856465631
40027200601,40027200601,6203,4333,1870,0.698532967918749,0.301467032081251
40027200602,40027200602,3448,2699,749,0.782772621809745,0.217227378190255
40027200700,40027200700,272,205,67,0.753676470588235,0.246323529411765
40027200800,40027200800,6574,5158,1416,0.784606023729845,0.215393976270155
40027200900,40027200900,3946,3250,696,0.823618854536239,0.176381145463761
40027201000,40027201000,5774,4507,1267,0.78056806373398,0.21943193626602
40027201102,40027201102,2783,2300,483,0.826446280991736,0.173553719008264
40027201201,40027201201,2121,1488,633,0.701555869872702,0.298444130127298
40027201202,40027201202,4771,3953,818,0.828547474324041,0.171452525675959
40027201203,40027201203,5396,3673,1723,0.680689399555226,0.319310600444774
40027201301,40027201301,7499,5554,1945,0.740632084277904,0.259367915722096
40027201404,40027201404,2328,1854,474,0.79639175257732,0.20360824742268
40027201505,40027201505,5522,4725,797,0.855668236146324,0.144331763853676
40027201507,40027201507,6318,5216,1102,0.825577714466603,0.174422285533397
40027201508,40027201508,3028,2460,568,0.812417437252312,0.187582562747688
40027201509,40027201509,2364,1951,413,0.825296108291032,0.174703891708968
40027201510,40027201510,6640,5512,1128,0.830120481927711,0.169879518072289
40027201602,40027201602,2713,2236,477,0.824179874677479,0.175820125322521
40027201603,40027201603,3895,3029,866,0.777663671373556,0.222336328626444
40027201604,40027201604,3671,2875,796,0.783165350040861,0.216834649959139
40027201607,40027201607,5181,4037,1144,0.779193205944798,0.220806794055202
40027201609,40027201609,4070,3045,1025,0.748157248157248,0.251842751842752
40027201610,40027201610,3708,2875,833,0.775350593311758,0.224649406688242
40027201612,40027201612,5074,4069,1005,0.801931415057154,0.198068584942846
40027201801,40027201801,4143,3195,948,0.771180304127444,0.228819695872556
40027201802,40027201802,3435,2840,595,0.826783114992722,0.173216885007278
40027201902,40027201902,4230,3190,1040,0.754137115839243,0.245862884160757
40027201903,40027201903,2926,1942,984,0.663704716336295,0.336295283663705
40027201904,40027201904,4598,3261,1337,0.70922140060896,0.29077859939104
40027202002,40027202002,4244,3375,869,0.795240339302545,0.204759660697455
40027202004,40027202004,3588,2891,697,0.805741360089186,0.194258639910814
40027202006,40027202006,2854,1963,891,0.687806587245971,0.312193412754029
40027202007,40027202007,3607,2595,1012,0.719434433046853,0.280565566953147
40027202008,40027202008,3825,3000,825,0.784313725490196,0.215686274509804
40027202102,40027202102,2454,2054,400,0.837000814995925,0.162999185004075
40027202106,40027202106,6183,4962,1221,0.802523047064532,0.197476952935468
40027202107,40027202107,2264,1772,492,0.782685512367491,0.217314487632509
40027202201,40027202201,3192,2629,563,0.823621553884712,0.176378446115288
40027202203,40027202203,3713,2953,760,0.795313762456235,0.204686237543765
40027202205,40027202205,6445,5089,1356,0.789604344453064,0.210395655546936
40027202206,40027202206,2819,2245,574,0.796381695636751,0.203618304363249
40027202302,40027202302,5986,5105,881,0.85282325425994,0.14717674574006
40027202402,40027202402,6212,5184,1028,0.834513844172569,0.165486155827431
40027202403,40027202403,5259,4615,644,0.877543259174748,0.122456740825252
40027202404,40027202404,4397,3835,562,0.872185581078008,0.127814418921992
40027202405,40027202405,7006,5230,1776,0.746502997430774,0.253497002569226
40027202500,40027202500,6720,5760,960,0.857142857142857,0.142857142857143
40027202600,40027202600,2670,2196,474,0.82247191011236,0.17752808988764
40051000100,40051000100,1275,1019,256,0.79921568627451,0.20078431372549
40051000400,40051000400,3277,2687,590,0.819957277998169,0.180042722001831
40051000500,40051000500,6509,5475,1034,0.841143032723921,0.158856967276079
40051000600,40051000600,5369,4637,732,0.863661761966847,0.136338238033153
40051000700,40051000700,7465,6510,955,0.872069658405894,0.127930341594106
40051000903,40051000903,9327,8314,1013,0.89139058646939,0.10860941353061
40051001000,40051001000,3945,2800,1145,0.709759188846641,0.290240811153359
40073958400,40073958400,2690,2434,256,0.904832713754647,0.0951672862453532
40081961300,40081961300,4319,3795,524,0.878675619356333,0.121324380643667
40081961400,40081961400,7782,6671,1111,0.857234644050373,0.142765355949627
40083600100,40083600100,4525,3200,1325,0.707182320441989,0.292817679558011
40083600200,40083600200,2760,2126,634,0.770289855072464,0.229710144927536
40083600400,40083600400,8379,7313,1066,0.872777181047858,0.127222818952142
40083600500,40083600500,7281,6347,934,0.871720917456393,0.128279082543607
40083600600,40083600600,4338,2261,2077,0.521207929921623,0.478792070078377
40087400101,40087400101,6671,5734,937,0.859541298156199,0.140458701843801
40087400102,40087400102,9323,8235,1088,0.883299367156495,0.116700632843505
40087400202,40087400202,7996,6747,1249,0.843796898449225,0.156203101550775
40087400300,40087400300,5497,4349,1148,0.79115881389849,0.20884118610151
40109100100,40109100100,3393,2096,1297,0.617742410845859,0.382257589154141
40109100200,40109100200,6378,3784,2594,0.593289432423957,0.406710567576043
40109100300,40109100300,2648,2199,449,0.830438066465257,0.169561933534743
40109100500,40109100500,1909,88,1821,0.0460974332111053,0.953902566788895
40109100600,40109100600,727,615,112,0.845942228335626,0.154057771664374
40109100700,40109100700,1429,885,544,0.619314205738279,0.380685794261721
40109100800,40109100800,2405,1297,1108,0.539293139293139,0.460706860706861
40109101000,40109101000,2964,1389,1575,0.468623481781377,0.531376518218623
40109101500,40109101500,1656,398,1258,0.240338164251208,0.759661835748792
40109101700,40109101700,1199,1038,161,0.865721434528774,0.134278565471226
40109101900,40109101900,2793,1885,908,0.674901539563194,0.325098460436806
40109102000,40109102000,3022,1820,1202,0.602250165453342,0.397749834546658
40109102100,40109102100,2148,1421,727,0.661545623836127,0.338454376163873
40109102200,40109102200,2787,1507,1280,0.540724793684966,0.459275206315034
40109102300,40109102300,3495,1741,1754,0.498140200286123,0.501859799713877
40109102400,40109102400,3389,1357,2032,0.400413101209796,0.599586898790204
40109102500,40109102500,542,340,202,0.627306273062731,0.372693726937269
40109102700,40109102700,130,72,58,0.553846153846154,0.446153846153846
40109102800,40109102800,2615,247,2368,0.0944550669216061,0.905544933078394
40109102900,40109102900,607,9,598,0.014827018121911,0.985172981878089
40109103200,40109103200,3498,1881,1617,0.537735849056604,0.462264150943396
40109103500,40109103500,351,191,160,0.544159544159544,0.455840455840456
40109103800,40109103800,467,380,87,0.813704496788009,0.186295503211991
40109103900,40109103900,3960,1723,2237,0.43510101010101,0.56489898989899
40109104100,40109104100,3145,1312,1833,0.417170111287758,0.582829888712242
40109104200,40109104200,2379,991,1388,0.416561580496007,0.583438419503993
40109104300,40109104300,3372,1386,1986,0.411032028469751,0.588967971530249
40109104400,40109104400,3729,1643,2086,0.440600697237865,0.559399302762135
40109104500,40109104500,3639,1485,2154,0.408079142621599,0.591920857378401
40109104600,40109104600,1076,497,579,0.461895910780669,0.538104089219331
40109104700,40109104700,1258,566,692,0.449920508744038,0.550079491255962
40109104800,40109104800,3221,1855,1366,0.57590810307358,0.42409189692642
40109104900,40109104900,3861,1888,1973,0.488992488992489,0.511007511007511
40109105000,40109105000,2486,1250,1236,0.502815768302494,0.497184231697506
40109105100,40109105100,1661,1041,620,0.626730885009031,0.373269114990969
40109105300,40109105300,3109,1446,1663,0.46510131875201,0.53489868124799
40109105500,40109105500,3414,1626,1788,0.476274165202109,0.523725834797891
40109105600,40109105600,5182,2125,3057,0.410073330760324,0.589926669239676
40109105700,40109105700,1068,529,539,0.495318352059925,0.504681647940075
40109105800,40109105800,819,513,306,0.626373626373626,0.373626373626374
40109105903,40109105903,2856,1922,934,0.67296918767507,0.32703081232493
40109105904,40109105904,3829,2147,1682,0.56072081483416,0.43927918516584
40109105905,40109105905,2817,1903,914,0.675541356052538,0.324458643947462
40109105906,40109105906,2813,1912,901,0.679701386420192,0.320298613579808
40109105907,40109105907,4152,2517,1635,0.60621387283237,0.39378612716763
40109106100,40109106100,3177,549,2628,0.172804532577904,0.827195467422096
40109106301,40109106301,3583,773,2810,0.215740999162713,0.784259000837287
40109106302,40109106302,4564,983,3581,0.215381244522349,0.784618755477651
40109106402,40109106402,2026,1822,204,0.899308983218164,0.100691016781836
40109106501,40109106501,2807,2275,532,0.810473815461347,0.189526184538653
40109106502,40109106502,3629,2533,1096,0.697988426563792,0.302011573436208
40109106503,40109106503,1422,1148,274,0.807313642756681,0.192686357243319
40109106602,40109106602,2555,1915,640,0.749510763209393,0.250489236790607
40109106604,40109106604,2312,1361,951,0.588667820069204,0.411332179930796
40109106606,40109106606,2027,1610,417,0.794277257030094,0.205722742969906
40109106607,40109106607,3341,2395,946,0.716851242143071,0.283148757856929
40109106608,40109106608,2968,2431,537,0.819070080862534,0.180929919137466
40109106609,40109106609,1237,1009,228,0.815683104284559,0.184316895715441
40109106610,40109106610,1418,975,443,0.687588152327221,0.312411847672779
40109106702,40109106702,3755,2614,1141,0.696138482023968,0.303861517976032
40109106704,40109106704,2243,1865,378,0.831475702184574,0.168524297815426
40109106706,40109106706,3889,2638,1251,0.678323476472101,0.321676523527899
40109106708,40109106708,2110,1548,562,0.733649289099526,0.266350710900474
40109106802,40109106802,1885,1503,382,0.797347480106101,0.202652519893899
40109106803,40109106803,3002,2009,993,0.669220519653564,0.330779480346436
40109106804,40109106804,3736,2590,1146,0.693254817987152,0.306745182012848
40109106902,40109106902,2359,1746,613,0.740144128868164,0.259855871131836
40109106903,40109106903,5805,4721,1084,0.813264427217916,0.186735572782084
40109106906,40109106906,2735,1695,1040,0.619744058500914,0.380255941499086
40109106907,40109106907,2165,1288,877,0.594919168591224,0.405080831408776
40109106909,40109106909,1516,1076,440,0.70976253298153,0.29023746701847
40109106911,40109106911,1755,1293,462,0.736752136752137,0.263247863247863
40109106912,40109106912,2940,1357,1583,0.46156462585034,0.53843537414966
40109106913,40109106913,3904,2042,1862,0.523053278688525,0.476946721311475
40109106914,40109106914,3717,2152,1565,0.578961528114071,0.421038471885929
40109106915,40109106915,6097,2387,3710,0.39150401836969,0.60849598163031
40109107001,40109107001,5885,3017,2868,0.512659303313509,0.487340696686491
40109107002,40109107002,1918,1056,862,0.550573514077164,0.449426485922836
40109107101,40109107101,31,24,7,0.774193548387097,0.225806451612903
40109107103,40109107103,1913,1094,819,0.571876633559854,0.428123366440146
40109107206,40109107206,4261,2691,1570,0.631541891574748,0.368458108425252
40109107207,40109107207,1972,1277,695,0.647565922920893,0.352434077079107
40109107209,40109107209,5523,2948,2575,0.533767879775484,0.466232120224516
40109107210,40109107210,1063,832,231,0.782690498588899,0.217309501411101
40109107211,40109107211,2120,1482,638,0.699056603773585,0.300943396226415
40109107212,40109107212,6062,3867,2195,0.637908281095348,0.362091718904652
40109107213,40109107213,4848,2836,2012,0.584983498349835,0.415016501650165
40109107214,40109107214,2785,1750,1035,0.628366247755835,0.371633752244165
40109107215,40109107215,3989,2396,1593,0.60065179242918,0.39934820757082
40109107216,40109107216,3236,1624,1612,0.501854140914709,0.498145859085291
40109107217,40109107217,1913,1056,857,0.552012545739676,0.447987454260324
40109107218,40109107218,2992,1578,1414,0.5274064171123,0.4725935828877
40109107219,40109107219,3049,1798,1251,0.589701541489013,0.410298458510987
40109107220,40109107220,3547,1862,1685,0.524950662531717,0.475049337468283
40109107221,40109107221,2047,1282,765,0.62628236443576,0.37371763556424
40109107222,40109107222,1803,1013,790,0.561841375485302,0.438158624514698
40109107223,40109107223,2703,1657,1046,0.613022567517573,0.386977432482427
40109107302,40109107302,2510,1473,1037,0.586852589641434,0.413147410358566
40109107303,40109107303,1715,1212,503,0.706705539358601,0.293294460641399
40109107306,40109107306,3787,1919,1868,0.506733562186427,0.493266437813573
40109107403,40109107403,5504,3186,2318,0.578851744186046,0.421148255813954
40109107404,40109107404,3385,1669,1716,0.493057607090103,0.506942392909897
40109107405,40109107405,4435,2698,1737,0.608342728297632,0.391657271702368
40109107500,40109107500,2859,2089,770,0.730675061210213,0.269324938789787
40109107604,40109107604,1809,1422,387,0.786069651741294,0.213930348258706
40109107606,40109107606,240,198,42,0.825,0.175
40109107607,40109107607,3361,2426,935,0.721808985421006,0.278191014578994
40109107703,40109107703,3462,2617,845,0.755921432697862,0.244078567302138
40109107704,40109107704,1616,1208,408,0.747524752475248,0.252475247524752
40109107801,40109107801,3544,1621,1923,0.457392776523702,0.542607223476298
40109107804,40109107804,2424,1900,524,0.783828382838284,0.216171617161716
40109107805,40109107805,2524,1479,1045,0.585974643423138,0.414025356576862
40109107806,40109107806,3921,2825,1096,0.720479469523081,0.279520530476919
40109107807,40109107807,2794,1946,848,0.696492483894059,0.303507516105941
40109107808,40109107808,1835,1185,650,0.645776566757493,0.354223433242507
40109107809,40109107809,1655,1214,441,0.733534743202417,0.266465256797583
40109107810,40109107810,2701,2034,667,0.753054424287301,0.246945575712699
40109108003,40109108003,4098,1414,2684,0.345046364080039,0.654953635919961
40109108005,40109108005,2382,835,1547,0.350545759865659,0.649454240134341
40109108006,40109108006,4029,2750,1279,0.682551501613304,0.317448498386696
40109108007,40109108007,3057,2280,777,0.745829244357213,0.254170755642787
40109108009,40109108009,2986,1529,1457,0.512056262558607,0.487943737441393
40109108010,40109108010,3058,1507,1551,0.492805755395683,0.507194244604317
40109108101,40109108101,3389,2831,558,0.835349660666863,0.164650339333137
40109108106,40109108106,4743,4259,484,0.897954880877082,0.102045119122918
40109108107,40109108107,2790,2500,290,0.896057347670251,0.103942652329749
40109108109,40109108109,5290,4806,484,0.908506616257089,0.0914933837429112
40109108113,40109108113,4686,3776,910,0.805804524114383,0.194195475885617
40109108114,40109108114,4367,3449,918,0.789787039157316,0.210212960842684
40109108201,40109108201,3599,2875,724,0.798833009169214,0.201166990830786
40109108203,40109108203,3034,2428,606,0.800263678312459,0.199736321687541
40109108204,40109108204,2739,1659,1080,0.605695509309967,0.394304490690033
40109108206,40109108206,4087,3682,405,0.900905309517984,0.0990946904820161
40109108207,40109108207,1571,1078,493,0.686187141947804,0.313812858052196
40109108208,40109108208,4291,2880,1411,0.671172220927523,0.328827779072477
40109108215,40109108215,4738,4002,736,0.844660194174757,0.155339805825243
40109108216,40109108216,2892,2281,611,0.788727524204703,0.211272475795297
40109108217,40109108217,4295,3500,795,0.814901047729919,0.185098952270081
40109108218,40109108218,8014,6006,2008,0.749438482655353,0.250561517344647
40109108219,40109108219,4384,3629,755,0.827782846715328,0.172217153284672
40109108220,40109108220,5167,4079,1088,0.789432939810335,0.210567060189665
40109108301,40109108301,1561,542,1019,0.3472133247918,0.6527866752082
40109108302,40109108302,4354,3040,1314,0.698208543867708,0.301791456132292
40109108303,40109108303,6807,5228,1579,0.768032907301307,0.231967092698693
40109108304,40109108304,4882,4147,735,0.849446947972143,0.150553052027857
40109108307,40109108307,4845,2373,2472,0.489783281733746,0.510216718266254
40109108309,40109108309,2363,430,1933,0.181972069403301,0.818027930596699
40109108310,40109108310,2579,972,1607,0.37689026754556,0.62310973245444
40109108313,40109108313,5374,2470,2904,0.459620394491998,0.540379605508001
40109108314,40109108314,2598,1339,1259,0.515396458814473,0.484603541185527
40109108315,40109108315,5003,3574,1429,0.714371377173696,0.285628622826304
40109108316,40109108316,5993,4589,1404,0.765726681127983,0.234273318872017
40109108317,40109108317,3410,2665,745,0.781524926686217,0.218475073313783
40109108402,40109108402,1323,1150,173,0.869236583522298,0.130763416477702
40109108504,40109108504,6700,5204,1496,0.776716417910448,0.223283582089552
40109108506,40109108506,3224,2735,489,0.848325062034739,0.151674937965261
40109108507,40109108507,1150,1040,110,0.904347826086957,0.0956521739130435
40109108508,40109108508,2000,1386,614,0.693,0.307
40109108511,40109108511,5284,4357,927,0.824564723694171,0.175435276305829
40109108513,40109108513,3694,2623,1071,0.710070384407147,0.289929615592853
40109108514,40109108514,5009,2939,2070,0.58674386105011,0.41325613894989
40109108515,40109108515,5212,4098,1114,0.786262471220261,0.213737528779739
40109108519,40109108519,3318,2779,539,0.837552742616034,0.162447257383966
40109108521,40109108521,1426,898,528,0.629733520336606,0.370266479663394
40109108523,40109108523,5378,3898,1480,0.724804760133879,0.275195239866121
40109108524,40109108524,3237,2230,1007,0.688909484090207,0.311090515909793
40109108525,40109108525,2107,1412,695,0.670147128618889,0.329852871381111
40109108526,40109108526,4965,3092,1873,0.622759315206445,0.377240684793555
40109108527,40109108527,5086,3652,1434,0.718049547778215,0.281950452221785
40109108528,40109108528,2155,1436,719,0.666357308584687,0.333642691415313
40109108530,40109108530,4128,2970,1158,0.719476744186046,0.280523255813954
40109108601,40109108601,2214,1588,626,0.717253839205059,0.282746160794941
40109108603,40109108603,2099,1742,357,0.82991900905193,0.17008099094807
40109108701,40109108701,2529,2096,433,0.828786081455121,0.171213918544879
40109108703,40109108703,5340,4630,710,0.867041198501873,0.132958801498127
40109108704,40109108704,4912,4249,663,0.865024429967427,0.134975570032573
40109108706,40109108706,2739,2143,596,0.782402336619204,0.217597663380796
40109108707,40109108707,3401,2585,816,0.760070567480153,0.239929432519847
40109108708,40109108708,3263,2884,379,0.883849218510573,0.116150781489427
40109108709,40109108709,3402,2977,425,0.875073486184597,0.124926513815403
40109108802,40109108802,4912,4091,821,0.832858306188925,0.167141693811075
40109108900,40109108900,3658,2777,881,0.759158009841443,0.240841990158557
40109109001,40109109001,2076,1735,341,0.835741811175337,0.164258188824663
40109109003,40109109003,4726,3978,748,0.841726618705036,0.158273381294964
40109109201,40109109201,5486,4678,808,0.852716004374772,0.147283995625228
40125501001,40125501001,8391,6388,2003,0.76129186032654,0.23870813967346
40125501003,40125501003,4293,3593,700,0.836943862101095,0.163056137898905
40125501102,40125501102,7907,6282,1625,0.794485898570887,0.205514101429113
40125501300,40125501300,2900,2381,519,0.821034482758621,0.178965517241379
40017300802,40017300802,2513,2332,181,0.927974532431357,0.072025467568643
40017300500,40017300500,3078,2266,812,0.736192332683561,0.263807667316439
40017300902,40017300902,2490,2169,321,0.871084337349398,0.128915662650602
40017301001,40017301001,76,69,7,0.907894736842105,0.0921052631578947
40017301009,40017301009,2770,2416,354,0.872202166064982,0.127797833935018
40027201101,40027201101,5464,4549,915,0.832540263543192,0.167459736456808
40027201403,40027201403,4966,4078,888,0.821184051550544,0.178815948449456
40027201405,40027201405,5378,4280,1098,0.79583488285608,0.20416511714392
40027201611,40027201611,2214,1828,386,0.825654923215899,0.174345076784101
40027201700,40027201700,1701,1452,249,0.853615520282187,0.146384479717813
40027202005,40027202005,6173,4386,1787,0.710513526648307,0.289486473351693
40027202104,40027202104,2338,1935,403,0.827630453378956,0.172369546621044
40027202105,40027202105,4374,3433,941,0.784865112025606,0.215134887974394
40027202301,40027202301,5409,4586,823,0.847846182288778,0.152153817711222
40051000800,40051000800,6981,6230,751,0.892422289070334,0.107577710929666
40051000901,40051000901,2534,2316,218,0.91397000789266,0.0860299921073402
40051000902,40051000902,5749,5006,743,0.870760132196904,0.129239867803096
40083600300,40083600300,2199,1772,427,0.805820827648931,0.194179172351069
40083600800,40083600800,7704,6801,903,0.882788161993769,0.117211838006231
40109100400,40109100400,2370,152,2218,0.0641350210970464,0.935864978902954
40109100900,40109100900,1516,1149,367,0.757915567282322,0.242084432717678
40109101100,40109101100,838,512,326,0.610978520286396,0.389021479713604
40109101200,40109101200,1196,751,445,0.627926421404682,0.372073578595318
40109101300,40109101300,2895,150,2745,0.0518134715025907,0.948186528497409
40109101400,40109101400,1062,69,993,0.0649717514124294,0.935028248587571
40109101600,40109101600,466,332,134,0.71244635193133,0.28755364806867
40109101800,40109101800,1416,1126,290,0.795197740112994,0.204802259887006
40109102600,40109102600,437,97,340,0.221967963386728,0.778032036613272
40109103000,40109103000,358,59,299,0.164804469273743,0.835195530726257
40109103300,40109103300,1704,642,1062,0.376760563380282,0.623239436619718
40109103400,40109103400,373,161,212,0.431635388739946,0.568364611260054
40109103601,40109103601,226,190,36,0.84070796460177,0.15929203539823
40109103602,40109103602,704,485,219,0.688920454545455,0.311079545454545
40109103700,40109103700,514,259,255,0.503891050583658,0.496108949416342
40109104000,40109104000,227,64,163,0.281938325991189,0.718061674008811
40109105201,40109105201,1505,19,1486,0.012624584717608,0.987375415282392
40109105202,40109105202,1156,18,1138,0.0155709342560554,0.984429065743945
40109105400,40109105400,1796,1111,685,0.618596881959911,0.381403118040089
40109106000,40109106000,2067,581,1486,0.281083696178036,0.718916303821964
40109106200,40109106200,1488,169,1319,0.113575268817204,0.886424731182796
40109106303,40109106303,3283,1859,1424,0.566250380749315,0.433749619250685
40109106401,40109106401,2111,1975,136,0.935575556608243,0.0644244433917575
40109106403,40109106403,4927,4136,791,0.83945605845342,0.16054394154658
40109106601,40109106601,3009,2169,840,0.720837487537388,0.279162512462612
40109106705,40109106705,2098,1590,508,0.757864632983794,0.242135367016206
40109106707,40109106707,6156,3269,2887,0.531026640675763,0.468973359324237
40109106801,40109106801,1936,1553,383,0.802169421487603,0.197830578512397
40109106910,40109106910,2020,1506,514,0.745544554455446,0.254455445544554
40109107104,40109107104,2958,1521,1437,0.51419878296146,0.48580121703854
40109107305,40109107305,1360,793,567,0.583088235294118,0.416911764705882
40109107401,40109107401,6402,2338,4064,0.365198375507654,0.634801624492346
40109107601,40109107601,1958,1304,654,0.665985699693565,0.334014300306435
40109107605,40109107605,2328,1760,568,0.756013745704467,0.243986254295533
40109107705,40109107705,2093,1564,529,0.747252747252747,0.252747252747253
40109107706,40109107706,2820,1962,858,0.695744680851064,0.304255319148936
40109107707,40109107707,1276,995,281,0.779780564263323,0.220219435736677
40109107900,40109107900,1675,112,1563,0.066865671641791,0.933134328358209
40109108008,40109108008,4418,2041,2377,0.461973743775464,0.538026256224536
40109108011,40109108011,3506,943,2563,0.268967484312607,0.731032515687393
40109108110,40109108110,3980,3363,617,0.844974874371859,0.155025125628141
40109108213,40109108213,8144,7492,652,0.919941060903733,0.0800589390962672
40109108221,40109108221,5574,4728,846,0.848223896663079,0.151776103336921
40109108318,40109108318,5068,3557,1511,0.701854775059195,0.298145224940805
40109108403,40109108403,2001,1615,386,0.807096451774113,0.192903548225887
40109108404,40109108404,2573,1901,672,0.738826272833269,0.261173727166731
40109108512,40109108512,4250,3770,480,0.887058823529412,0.112941176470588
40109108520,40109108520,1875,1616,259,0.861866666666667,0.138133333333333
40109108529,40109108529,2798,2303,495,0.823087919942816,0.176912080057184
40109108602,40109108602,935,766,169,0.819251336898396,0.180748663101604
40109108801,40109108801,6549,4963,1586,0.757825622232402,0.242174377767598
40109108803,40109108803,1088,82,1006,0.0753676470588235,0.924632352941177
40109108804,40109108804,2637,1504,1133,0.57034508911642,0.42965491088358
40109109004,40109109004,3473,2977,496,0.857183990786064,0.142816009213936
40109109100,40109109100,251,128,123,0.50996015936255,0.49003984063745
40109109202,40109109202,2363,1999,364,0.84595852729581,0.15404147270419
