"GEOID","GEO.display.label","pop","pop.white","pop.not.white","pct.white","pct.not.white"
29071800100,29071800100,8584,8340,244,0.971575023299161,0.0284249767008388
29071800202,29071800202,5564,5437,127,0.977174694464414,0.0228253055355859
29071800601,29071800601,6903,6623,280,0.95943792553962,0.0405620744603795
29071800602,29071800602,8402,8117,285,0.966079504879791,0.0339204951202094
29071800702,29071800702,3083,2927,156,0.949399935128122,0.0506000648718781
29071800901,29071800901,3122,3033,89,0.97149263292761,0.0285073670723895
29071800902,29071800902,6727,6518,209,0.968931172885387,0.0310688271146128
29071801000,29071801000,3758,3675,83,0.977913783927621,0.0220862160723789
29099700107,29099700107,2836,2761,75,0.973554301833568,0.0264456981664316
29099700109,29099700109,12720,12311,409,0.967845911949686,0.0321540880503145
29099700110,29099700110,8013,7717,296,0.963060027455385,0.036939972544615
29099700111,29099700111,3938,3788,150,0.961909598781107,0.0380904012188928
29099700113,29099700113,3579,3469,110,0.969265157865326,0.0307348421346745
29099700114,29099700114,4485,4330,155,0.965440356744705,0.0345596432552955
29099700115,29099700115,4333,4214,119,0.972536348949919,0.0274636510500808
29099700116,29099700116,3125,3019,106,0.96608,0.03392
29099700203,29099700203,6005,5660,345,0.942547876769359,0.0574521232306411
29099700206,29099700206,5312,5111,201,0.962161144578313,0.0378388554216867
29099700207,29099700207,3659,3527,132,0.963924569554523,0.0360754304454769
29099700208,29099700208,5818,5589,229,0.960639394981093,0.0393606050189068
29099700210,29099700210,3923,3744,179,0.954371654346164,0.0456283456538363
29099700211,29099700211,5259,5021,238,0.954744247955885,0.0452557520441148
29099700304,29099700304,7149,6921,228,0.968107427612253,0.0318925723877466
29099700401,29099700401,4746,4632,114,0.975979772439949,0.0240202275600506
29099700502,29099700502,5812,5645,167,0.971266345492085,0.0287336545079147
29099700503,29099700503,3416,3358,58,0.983021077283372,0.0169789227166276
29099700504,29099700504,4393,4285,108,0.975415433644434,0.0245845663555657
29099700601,29099700601,5510,5286,224,0.95934664246824,0.0406533575317605
29099700603,29099700603,6060,5921,139,0.977062706270627,0.0229372937293729
29099700604,29099700604,5964,5844,120,0.979879275653924,0.0201207243460765
29099700605,29099700605,6149,5957,192,0.968775410635876,0.0312245893641242
29099700700,29099700700,4736,4405,331,0.930109797297297,0.0698902027027027
29099700802,29099700802,4371,4157,214,0.951040951727294,0.0489590482727065
29099701000,29099701000,8574,8339,235,0.972591555866573,0.0274084441334267
29099701102,29099701102,5792,5668,124,0.978591160220994,0.0214088397790055
29099701200,29099701200,5856,5662,194,0.966871584699454,0.0331284153005464
29099701401,29099701401,3918,3841,77,0.980347115875447,0.0196528841245533
29099701403,29099701403,3920,3817,103,0.973724489795918,0.0262755102040816
29099701404,29099701404,5949,5775,174,0.970751386787695,0.0292486132123045
29113810100,29113810100,4269,3992,277,0.935113609744671,0.0648863902553292
29113810201,29113810201,6535,6226,309,0.952716143840857,0.0472838561591431
29113810202,29113810202,5805,5671,134,0.976916451335056,0.023083548664944
29113810301,29113810301,9138,8400,738,0.919238345370978,0.0807616546290216
29113810303,29113810303,8180,7748,432,0.94718826405868,0.0528117359413203
29113810304,29113810304,10149,9628,521,0.948664893092916,0.0513351069070844
29113810400,29113810400,8490,8273,217,0.974440518256773,0.0255594817432273
29183310100,29183310100,2342,2285,57,0.975661827497865,0.0243381725021349
29183310201,29183310201,2679,2473,206,0.923105636431504,0.0768943635684957
29183310202,29183310202,3747,3429,318,0.915132105684548,0.0848678943154524
29183310301,29183310301,4142,3951,191,0.953887011105746,0.046112988894254
29183310302,29183310302,3666,3233,433,0.881887615930169,0.118112384069831
29183310501,29183310501,6750,5443,1307,0.80637037037037,0.19362962962963
29183310602,29183310602,5787,5462,325,0.9438396405737,0.0561603594263004
29183310700,29183310700,5261,4570,691,0.868656149021099,0.131343850978901
29183310801,29183310801,2187,1937,250,0.885688157293096,0.114311842706904
29183310802,29183310802,5775,5183,592,0.897489177489177,0.102510822510823
29183310902,29183310902,5144,4541,603,0.882776049766719,0.117223950233281
29183310903,29183310903,4086,3670,416,0.898188937836515,0.101811062163485
29183311001,29183311001,4049,3442,607,0.850086441096567,0.149913558903433
29183311004,29183311004,5144,4161,983,0.808903576982893,0.191096423017107
29183311103,29183311103,6622,6286,336,0.949260042283298,0.0507399577167019
29183311122,29183311122,6773,5751,1022,0.8491067473793,0.1508932526207
29183311124,29183311124,6581,5981,600,0.908828445524996,0.0911715544750038
29183311132,29183311132,3447,3255,192,0.944299390774587,0.0557006092254134
29183311146,29183311146,4416,3893,523,0.881567028985507,0.118432971014493
29183311147,29183311147,4039,3720,319,0.921020054468928,0.078979945531072
29183311148,29183311148,4517,4244,273,0.939561655966349,0.0604383440336507
29183311149,29183311149,3737,3418,319,0.914637409686915,0.0853625903130854
29183311150,29183311150,4749,4348,401,0.915561170772794,0.0844388292272057
29183311151,29183311151,5722,4890,832,0.854596295001748,0.145403704998252
29183311152,29183311152,4753,4435,318,0.933094887439512,0.0669051125604881
29183311154,29183311154,4970,4546,424,0.914688128772636,0.0853118712273642
29183311203,29183311203,6135,5597,538,0.912306438467808,0.0876935615321923
29183311211,29183311211,4386,3880,506,0.884632922936617,0.115367077063383
29183311212,29183311212,3625,3159,466,0.871448275862069,0.128551724137931
29183311221,29183311221,3683,3401,282,0.923431984795004,0.0765680152049959
29183311294,29183311294,3980,3726,254,0.936180904522613,0.063819095477387
29183311296,29183311296,4239,3971,268,0.936777541873083,0.0632224581269167
29183311311,29183311311,5156,4748,408,0.920868890612878,0.0791311093871218
29183311312,29183311312,5724,5270,454,0.920684835779175,0.0793151642208246
29183311322,29183311322,5786,5304,482,0.916695471828552,0.0833045281714483
29183311391,29183311391,4786,4384,402,0.916005014625992,0.0839949853740075
29183311422,29183311422,5653,5221,432,0.923580399787723,0.0764196002122767
29183311500,29183311500,1905,1758,147,0.922834645669291,0.0771653543307087
29183311602,29183311602,5259,4835,424,0.919376307282753,0.0806236927172467
29183311712,29183311712,4603,4079,524,0.886161199217901,0.113838800782099
29183311721,29183311721,3818,3394,424,0.888947092718701,0.111052907281299
29183311722,29183311722,7439,6746,693,0.906842317515795,0.0931576824842049
29183311732,29183311732,7277,6643,634,0.912876185241171,0.0871238147588292
29183311733,29183311733,2480,2268,212,0.914516129032258,0.0854838709677419
29183311734,29183311734,3693,3334,359,0.902789060384511,0.0972109396154888
29183311735,29183311735,6052,5494,558,0.907799074686054,0.0922009253139459
29183311736,29183311736,6379,5748,631,0.901081674243612,0.0989183257563881
29183311801,29183311801,4822,4504,318,0.934052260472833,0.0659477395271671
29183311802,29183311802,6143,5698,445,0.927559824190135,0.0724401758098648
29183311903,29183311903,5882,5387,495,0.915844950697042,0.0841550493029581
29183311904,29183311904,6016,5312,704,0.882978723404255,0.117021276595745
29183311908,29183311908,2831,2623,208,0.926527728717768,0.0734722712822324
29183311909,29183311909,5022,4774,248,0.950617283950617,0.0493827160493827
29183312001,29183312001,2312,2271,41,0.982266435986159,0.0177335640138409
29183312094,29183312094,4372,3702,670,0.846752058554437,0.153247941445563
29183312095,29183312095,3542,3172,370,0.89553924336533,0.10446075663467
29183312096,29183312096,6241,5675,566,0.909309405543983,0.0906905944560167
29183312097,29183312097,6639,6211,428,0.935532459707787,0.0644675402922127
29183312192,29183312192,3376,3149,227,0.932760663507109,0.067239336492891
29183312193,29183312193,6211,5754,457,0.92642086620512,0.07357913379488
29183312195,29183312195,3300,2903,397,0.87969696969697,0.12030303030303
29183312205,29183312205,6338,5610,728,0.885137267276743,0.114862732723257
29183312300,29183312300,2892,2764,128,0.955739972337483,0.0442600276625172
29183312400,29183312400,5016,4685,331,0.934011164274322,0.0659888357256778
29183980000,29183980000,1,1,0,1,0
29186960100,29186960100,6342,6216,126,0.980132450331126,0.0198675496688742
29186960200,29186960200,4989,4786,203,0.959310483062738,0.040689516937262
29186960300,29186960300,4064,4028,36,0.991141732283465,0.00885826771653542
29187950101,29187950101,4435,4346,89,0.979932356257046,0.0200676437429538
29187950102,29187950102,4765,4660,105,0.977964323189927,0.0220356768100735
29189210400,29189210400,4363,372,3991,0.0852624341049736,0.914737565895026
29189210501,29189210501,3667,151,3516,0.04117807472048,0.95882192527952
29189210600,29189210600,6740,2086,4654,0.309495548961424,0.690504451038576
29189210702,29189210702,6111,1154,4957,0.18883979708722,0.81116020291278
29189210803,29189210803,4881,1986,2895,0.406883835279656,0.593116164720344
29189210804,29189210804,9297,1355,7942,0.145745939550393,0.854254060449607
29189210805,29189210805,6364,961,5403,0.15100565681961,0.84899434318039
29189210912,29189210912,7022,3341,3681,0.475790373113073,0.524209626886927
29189210923,29189210923,5300,3495,1805,0.659433962264151,0.340566037735849
29189210927,29189210927,4665,2196,2469,0.470739549839228,0.529260450160772
29189210928,29189210928,4333,1688,2645,0.389568428340642,0.610431571659358
29189211000,29189211000,7414,4199,3215,0.5663609387645,0.4336390612355
29189211102,29189211102,5006,2128,2878,0.425089892129445,0.574910107870555
29189211201,29189211201,5109,2926,2183,0.572714816989626,0.427285183010374
29189211202,29189211202,3421,3072,349,0.897983045893014,0.102016954106986
29189211301,29189211301,6114,5295,819,0.866045142296369,0.133954857703631
29189211332,29189211332,6483,5122,1361,0.7900663273176,0.2099336726824
29189211402,29189211402,2211,1089,1122,0.492537313432836,0.507462686567164
29189211500,29189211500,3494,208,3286,0.0595306239267315,0.940469376073268
29189211600,29189211600,6200,2564,3636,0.413548387096774,0.586451612903226
29189211700,29189211700,3985,1668,2317,0.418569636135508,0.581430363864492
29189211801,29189211801,3965,516,3449,0.130138713745271,0.869861286254729
29189212001,29189212001,7506,737,6769,0.0981881161737277,0.901811883826272
29189212002,29189212002,3850,157,3693,0.0407792207792208,0.959220779220779
29189212101,29189212101,4401,359,4042,0.0815723699159282,0.918427630084072
29189212102,29189212102,3101,197,2904,0.0635278942276685,0.936472105772332
29189212300,29189212300,5037,814,4223,0.161604129442128,0.838395870557872
29189212400,29189212400,2349,333,2016,0.14176245210728,0.85823754789272
29189212500,29189212500,5071,1278,3793,0.252021297574443,0.747978702425557
29189213101,29189213101,4606,3274,1332,0.710811984368215,0.289188015631785
29189213102,29189213102,411,353,58,0.858880778588808,0.141119221411192
29189213202,29189213202,6811,5276,1535,0.7746292761709,0.2253707238291
29189213203,29189213203,4759,4151,608,0.872242067661273,0.127757932338727
29189213204,29189213204,3869,2205,1664,0.569914706642543,0.430085293357457
29189213300,29189213300,7213,3916,3297,0.542908637182864,0.457091362817136
29189213400,29189213400,6669,3811,2858,0.571449992502624,0.428550007497376
29189213500,29189213500,4983,3429,1554,0.688139674894642,0.311860325105358
29189213600,29189213600,4446,629,3817,0.141475483580747,0.858524516419253
29189213700,29189213700,5484,1766,3718,0.322027716994894,0.677972283005106
29189214200,29189214200,3370,274,3096,0.0813056379821959,0.918694362017804
29189214300,29189214300,4052,1295,2757,0.31959526159921,0.68040473840079
29189214400,29189214400,5082,3596,1486,0.707595434868162,0.292404565131838
29189214500,29189214500,3089,2170,919,0.702492716089349,0.297507283910651
29189214601,29189214601,3958,2930,1028,0.740272865083375,0.259727134916625
29189214602,29189214602,4141,3087,1054,0.745472108186428,0.254527891813572
29189214700,29189214700,6881,4597,2284,0.668071501235286,0.331928498764714
29189214800,29189214800,5571,4233,1338,0.759827679052235,0.240172320947765
29189214900,29189214900,6172,4254,1918,0.689241736876215,0.310758263123785
29189215001,29189215001,2645,1682,963,0.635916824196597,0.364083175803403
29189215003,29189215003,4308,3605,703,0.836815227483751,0.163184772516249
29189215004,29189215004,2761,2000,761,0.724375226367258,0.275624773632742
29189215005,29189215005,5491,3889,1602,0.708249863412857,0.291750136587143
29189215102,29189215102,4746,3634,1112,0.765697429414244,0.234302570585756
29189215105,29189215105,2349,1864,485,0.793529161345253,0.206470838654747
29189215141,29189215141,4193,3562,631,0.849511089911758,0.150488910088242
29189215142,29189215142,6855,4425,2430,0.645514223194748,0.354485776805252
29189215144,29189215144,5727,4648,1079,0.811594202898551,0.188405797101449
29189215202,29189215202,7020,5664,1356,0.806837606837607,0.193162393162393
29189215232,29189215232,7936,6821,1115,0.859501008064516,0.140498991935484
29189215302,29189215302,3289,2875,414,0.874125874125874,0.125874125874126
29189215400,29189215400,5159,4876,283,0.945144407830975,0.054855592169025
29189215500,29189215500,4759,3728,1031,0.783357848287455,0.216642151712545
29189215600,29189215600,4889,1659,3230,0.339333196972796,0.660666803027204
29189215700,29189215700,5747,983,4764,0.171045763006786,0.828954236993214
29189216000,29189216000,1753,173,1580,0.098687963491158,0.901312036508842
29189216100,29189216100,5479,3413,2066,0.622923891221026,0.377076108778974
29189216300,29189216300,6924,5293,1631,0.764442518775274,0.235557481224726
29189216400,29189216400,5537,4668,869,0.843055806393354,0.156944193606646
29189216600,29189216600,1889,1718,171,0.909475913181577,0.0905240868184225
29189216700,29189216700,3512,2547,965,0.725227790432802,0.274772209567198
29189216800,29189216800,3205,2765,440,0.862714508580343,0.137285491419657
29189216900,29189216900,2327,1700,627,0.730554361839278,0.269445638160722
29189217000,29189217000,3942,3004,938,0.762049720953831,0.237950279046169
29189217200,29189217200,1777,1262,515,0.710185706246483,0.289814293753517
29189217300,29189217300,2972,2487,485,0.836810228802153,0.163189771197847
29189217400,29189217400,4705,4221,484,0.897130712008502,0.102869287991498
29189217500,29189217500,5382,5120,262,0.951319212188777,0.0486807878112226
29189217600,29189217600,7115,6675,440,0.938158819395643,0.0618411806043569
29189217701,29189217701,4808,4204,604,0.874376039933444,0.125623960066556
29189217807,29189217807,6089,5490,599,0.901625882739366,0.0983741172606339
29189217841,29189217841,5187,4465,722,0.860805860805861,0.139194139194139
29189217842,29189217842,6965,5813,1152,0.834601579325197,0.165398420674803
29189217852,29189217852,6391,5844,547,0.914410890314505,0.0855891096854953
29189217921,29189217921,4958,4468,490,0.901169826542961,0.0988301734570391
29189217923,29189217923,7269,6504,765,0.894758563763929,0.105241436236071
29189217931,29189217931,6600,5900,700,0.893939393939394,0.106060606060606
29189217932,29189217932,4890,4027,863,0.823517382413088,0.176482617586912
29189217942,29189217942,5287,4626,661,0.874976357102326,0.125023642897674
29189217943,29189217943,3203,2770,433,0.864814236653138,0.135185763346862
29189217944,29189217944,5967,5242,725,0.878498407910173,0.121501592089827
29189218003,29189218003,7204,6455,749,0.896029983342587,0.103970016657413
29189218011,29189218011,6930,5676,1254,0.819047619047619,0.180952380952381
29189218103,29189218103,5493,4779,714,0.87001638448935,0.12998361551065
29189218201,29189218201,2788,2604,184,0.934002869440459,0.0659971305595409
29189218402,29189218402,4689,4485,204,0.956493921944978,0.0435060780550224
29189218500,29189218500,4746,4556,190,0.959966287399916,0.0400337126000843
29189218600,29189218600,2723,2003,720,0.735585751009916,0.264414248990084
29189218800,29189218800,5925,5732,193,0.967426160337553,0.0325738396624473
29189218900,29189218900,6269,3955,2314,0.630882118360185,0.369117881639815
29189219100,29189219100,4032,3819,213,0.947172619047619,0.0528273809523809
29189219300,29189219300,2039,1756,283,0.861206473761648,0.138793526238352
29189219400,29189219400,5964,5760,204,0.96579476861167,0.03420523138833
29189219700,29189219700,5964,5425,539,0.90962441314554,0.0903755868544601
29189219900,29189219900,5951,5410,541,0.909090909090909,0.0909090909090909
29189220001,29189220001,4991,4790,201,0.959727509517131,0.0402724904828692
29189220002,29189220002,3279,3077,202,0.938395852394023,0.0616041476059774
29189220100,29189220100,7542,6973,569,0.924555820737205,0.075444179262795
29189220200,29189220200,5702,5382,320,0.943879340582252,0.0561206594177481
29189220300,29189220300,1862,1549,313,0.831901181525242,0.168098818474758
29189220431,29189220431,8129,7529,600,0.926190183294378,0.0738098167056218
29189220432,29189220432,8049,7738,311,0.96136165983352,0.0386383401664803
29189220441,29189220441,5898,5562,336,0.943031536113937,0.056968463886063
29189220442,29189220442,4412,4235,177,0.95988213961922,0.0401178603807797
29189220444,29189220444,7704,7418,286,0.962876427829699,0.0371235721703012
29189220445,29189220445,4947,4783,164,0.966848595108146,0.0331514048918536
29189220446,29189220446,4584,4461,123,0.973167539267016,0.0268324607329843
29189220501,29189220501,6117,5779,338,0.944744155631846,0.0552558443681543
29189220502,29189220502,6741,6086,655,0.902833407506305,0.0971665924936953
29189220602,29189220602,5365,5095,270,0.949673811742777,0.0503261882572228
29189220701,29189220701,2573,2443,130,0.949475320637388,0.0505246793626117
29189220702,29189220702,3653,3506,147,0.959759102107857,0.0402408978921435
29189220802,29189220802,4738,4373,365,0.922963275643731,0.0770367243562685
29189221000,29189221000,3354,2323,1031,0.692605843768634,0.307394156231366
29189221100,29189221100,1833,1734,99,0.945990180032733,0.0540098199672667
29189221201,29189221201,3303,3118,185,0.943990311837723,0.0560096881622767
29189221202,29189221202,6067,5807,260,0.957145211801549,0.0428547881984507
29189221302,29189221302,6619,6139,480,0.927481492672609,0.0725185073273908
29189221332,29189221332,4433,4188,245,0.944732686668171,0.0552673133318294
29189221335,29189221335,5830,5553,277,0.952487135506003,0.0475128644939966
29189221421,29189221421,6679,6301,378,0.94340470130259,0.0565952986974098
29189221422,29189221422,8870,8346,524,0.940924464487035,0.0590755355129651
29189221423,29189221423,4035,3854,181,0.955142503097893,0.0448574969021066
29189221502,29189221502,6537,6281,256,0.96083830503289,0.0391616949671103
29189221503,29189221503,7235,6413,822,0.886385625431928,0.113614374568072
29189221506,29189221506,5028,4575,453,0.909904534606205,0.0900954653937948
29189221624,29189221624,3393,3069,324,0.904509283819629,0.0954907161803713
29189221625,29189221625,6762,6166,596,0.911860396332446,0.088139603667554
29189221626,29189221626,5978,5498,480,0.919705587152894,0.080294412847106
29189221627,29189221627,6513,5956,557,0.914478734838016,0.0855212651619838
29189221900,29189221900,3744,3541,203,0.945779914529915,0.0542200854700855
29189222000,29189222000,3818,3693,125,0.967260345730749,0.032739654269251
29189222100,29189222100,4978,4643,335,0.932703897147449,0.0672961028525513
29221460100,29221460100,6525,6390,135,0.979310344827586,0.0206896551724138
29510101100,29510101100,2600,2284,316,0.878461538461539,0.121538461538461
29510101200,29510101200,3100,2779,321,0.896451612903226,0.103548387096774
29510101300,29510101300,4336,3692,644,0.851476014760148,0.148523985239852
29510101400,29510101400,2703,1749,954,0.647058823529412,0.352941176470588
29510101800,29510101800,3092,1977,1115,0.639391979301423,0.360608020698577
29510102100,29510102100,2780,2512,268,0.903597122302158,0.0964028776978417
29510102300,29510102300,1846,1701,145,0.921451787648971,0.0785482123510293
29510102400,29510102400,2478,2120,358,0.855528652138822,0.144471347861178
29510103400,29510103400,1968,1831,137,0.930386178861789,0.0696138211382114
29510103700,29510103700,2531,2260,271,0.892927696562623,0.107072303437377
29510103800,29510103800,3819,3536,283,0.925896831631317,0.0741031683686829
29510104200,29510104200,3401,2964,437,0.871508379888268,0.128491620111732
29510107300,29510107300,4983,54,4929,0.0108368452739314,0.989163154726069
29510108200,29510108200,2698,99,2599,0.0366938472942921,0.963306152705708
29510108300,29510108300,2267,123,2144,0.0542567269519188,0.945743273048081
29510110300,29510110300,2483,20,2463,0.00805477245267821,0.991945227547322
29510111400,29510111400,1643,16,1627,0.00973828362751065,0.990261716372489
29510112100,29510112100,4285,2809,1476,0.655542590431739,0.344457409568261
29510113500,29510113500,2331,2200,131,0.943800943800944,0.0561990561990562
29510114101,29510114101,4281,3060,1221,0.714786264891381,0.285213735108619
29510114102,29510114102,4128,3871,257,0.937742248062015,0.0622577519379846
29510114200,29510114200,4721,3949,772,0.836475323024783,0.163524676975217
29510114300,29510114300,5485,4914,571,0.895897903372835,0.104102096627165
29510115100,29510115100,4287,3221,1066,0.75134126428738,0.24865873571262
29510115200,29510115200,3149,1635,1514,0.519212448396316,0.480787551603684
29510115300,29510115300,4958,2697,2261,0.543969342476805,0.456030657523195
29510115400,29510115400,3122,2241,881,0.717809096732864,0.282190903267136
29510115500,29510115500,5625,2228,3397,0.396088888888889,0.603911111111111
29510115700,29510115700,3567,1245,2322,0.349032800672834,0.650967199327166
29510116200,29510116200,4325,2780,1545,0.642774566473988,0.357225433526012
29510116301,29510116301,2999,1965,1034,0.655218406135378,0.344781593864622
29510116302,29510116302,3007,814,2193,0.270701696042567,0.729298303957433
29510116400,29510116400,4891,1215,3676,0.248415456961767,0.751584543038234
29510116500,29510116500,3844,1649,2195,0.4289802289282,0.5710197710718
29510117100,29510117100,1537,1076,461,0.700065061808718,0.299934938191282
29510117200,29510117200,5359,2517,2842,0.469677178578093,0.530322821421907
29510119101,29510119101,2584,1346,1238,0.520897832817337,0.479102167182663
29510119102,29510119102,2994,1913,1081,0.638944555778223,0.361055444221777
29510121100,29510121100,1941,267,1674,0.137557959814529,0.862442040185471
29510123200,29510123200,2298,1374,924,0.597911227154047,0.402088772845953
29510123300,29510123300,2586,1681,905,0.650038669760247,0.349961330239753
29510124100,29510124100,4644,1060,3584,0.228251507321275,0.771748492678725
29510124200,29510124200,3201,938,2263,0.293033427054046,0.706966572945954
29510124300,29510124300,3131,2034,1097,0.649632705206004,0.350367294793996
29510124600,29510124600,1845,578,1267,0.313279132791328,0.686720867208672
29510125600,29510125600,4113,2012,2101,0.489180646729881,0.510819353270119
29510125700,29510125700,3329,59,3270,0.0177230399519375,0.982276960048063
29510126800,29510126800,3698,3081,617,0.833153055705787,0.166846944294213
29510126900,29510126900,5016,52,4964,0.0103668261562998,0.9896331738437
29510127000,29510127000,2470,349,2121,0.141295546558704,0.858704453441296
29510127300,29510127300,3769,1040,2729,0.275935261342531,0.724064738657469
29510127400,29510127400,4795,1206,3589,0.251511991657977,0.748488008342023
29510127600,29510127600,3239,2440,799,0.753318925594319,0.246681074405681
29071800201,29071800201,5173,4967,206,0.960177846510729,0.0398221534892712
29071800701,29071800701,7308,6899,409,0.944033935413246,0.0559660645867542
29071800800,29071800800,7649,7313,336,0.956072689240424,0.0439273107595765
29099700117,29099700117,7172,6921,251,0.965002788622421,0.0349972113775795
29099700118,29099700118,6246,6023,223,0.964297150176113,0.0357028498238873
29099700119,29099700119,2145,2079,66,0.969230769230769,0.0307692307692308
29099700209,29099700209,3479,3298,181,0.947973555619431,0.0520264443805691
29099700302,29099700302,5469,5272,197,0.96397878954105,0.0360212104589505
29099700303,29099700303,4806,4643,163,0.96608406158968,0.0339159384103205
29099700402,29099700402,5548,5387,161,0.970980533525595,0.0290194664744052
29099700801,29099700801,5504,5232,272,0.950581395348837,0.0494186046511628
29099700900,29099700900,5340,4934,406,0.923970037453184,0.0760299625468165
29099701101,29099701101,4116,4022,94,0.977162293488824,0.0228377065111759
29099701300,29099701300,3588,3422,166,0.953734671125975,0.0462653288740246
29183310400,29183310400,2117,1920,197,0.906943788379783,0.0930562116202173
29183310502,29183310502,2865,2510,355,0.8760907504363,0.1239092495637
29183310601,29183310601,2060,1881,179,0.913106796116505,0.0868932038834952
29183310901,29183310901,2263,1865,398,0.824127264692886,0.175872735307114
29183311003,29183311003,3207,2504,703,0.780792017461802,0.219207982538198
29183311114,29183311114,4550,4200,350,0.923076923076923,0.0769230769230769
29183311145,29183311145,4256,3881,375,0.911889097744361,0.0881109022556391
29183311153,29183311153,6437,5722,715,0.888923411527109,0.111076588472891
29183311331,29183311331,4631,4339,292,0.936946663787519,0.0630533362124811
29183311601,29183311601,5648,5230,418,0.925991501416431,0.0740084985835694
29183311907,29183311907,6270,5623,647,0.896810207336523,0.103189792663477
29183312194,29183312194,2947,2801,146,0.950458092975908,0.0495419070240923
29183312204,29183312204,4813,4702,111,0.976937461043008,0.0230625389569915
29183312206,29183312206,4322,4138,184,0.957427117075428,0.042572882924572
29187950300,29187950300,7866,6450,1416,0.81998474446987,0.18001525553013
29189210100,29189210100,6017,1924,4093,0.319760678078777,0.680239321921223
29189210200,29189210200,6441,1086,5355,0.168607359105729,0.831392640894271
29189210300,29189210300,3466,946,2520,0.272937103289094,0.727062896710906
29189210502,29189210502,4049,212,3837,0.0523586070634725,0.947641392936527
29189210703,29189210703,3914,843,3071,0.215380684721513,0.784619315278487
29189210704,29189210704,4133,301,3832,0.0728284539075732,0.927171546092427
29189210806,29189210806,6004,587,5417,0.0977681545636243,0.902231845436376
29189210921,29189210921,4141,2082,2059,0.502777106978991,0.497222893021009
29189210924,29189210924,4576,1999,2577,0.436844405594406,0.563155594405594
29189210925,29189210925,5333,2901,2432,0.543971498218639,0.456028501781361
29189210926,29189210926,2688,2019,669,0.751116071428571,0.248883928571429
29189211101,29189211101,6959,4579,2380,0.657996838626239,0.342003161373761
29189211331,29189211331,6352,5059,1293,0.796442065491184,0.203557934508816
29189211333,29189211333,5148,3467,1681,0.673465423465423,0.326534576534577
29189211334,29189211334,4111,3340,771,0.812454390659207,0.187545609340793
29189211401,29189211401,5329,3855,1474,0.723400262713455,0.276599737286545
29189211802,29189211802,3843,601,3242,0.156388238355451,0.843611761644549
29189211900,29189211900,5454,380,5074,0.0696736340300697,0.93032636596993
29189212200,29189212200,6778,218,6560,0.0321628799055769,0.967837120094423
29189212600,29189212600,4671,2012,2659,0.430742881609934,0.569257118390066
29189212700,29189212700,5670,1498,4172,0.264197530864198,0.735802469135802
29189213800,29189213800,5778,133,5645,0.023018345448252,0.976981654551748
29189213900,29189213900,2189,24,2165,0.0109639104613979,0.989036089538602
29189214100,29189214100,1458,46,1412,0.0315500685871056,0.968449931412894
29189215103,29189215103,2549,1909,640,0.748921145547273,0.251078854452727
29189215143,29189215143,2975,2709,266,0.910588235294118,0.0894117647058823
29189215201,29189215201,6430,5090,1340,0.791601866251944,0.208398133748056
29189215231,29189215231,4504,3973,531,0.882104795737123,0.117895204262877
29189215301,29189215301,4264,3645,619,0.854831144465291,0.145168855534709
29189215800,29189215800,7801,5675,2126,0.72747083707217,0.27252916292783
29189215900,29189215900,7005,1540,5465,0.219842969307637,0.780157030692363
29189216200,29189216200,7589,6171,1418,0.81315061272895,0.18684938727105
29189216500,29189216500,4450,3190,1260,0.71685393258427,0.28314606741573
29189217702,29189217702,7561,6692,869,0.885068112683507,0.114931887316493
29189217802,29189217802,6944,6308,636,0.908410138248848,0.091589861751152
29189217806,29189217806,5360,4866,494,0.907835820895522,0.0921641791044776
29189217851,29189217851,3229,2953,276,0.914524620625581,0.0854753793744193
29189217941,29189217941,5829,5290,539,0.907531308972379,0.0924686910276206
29189218012,29189218012,4495,4164,331,0.926362625139043,0.0736373748609567
29189218102,29189218102,2984,2552,432,0.855227882037534,0.144772117962466
29189218300,29189218300,4146,3645,501,0.879160636758321,0.120839363241679
29189218401,29189218401,3820,3661,159,0.958376963350785,0.0416230366492146
29189219200,29189219200,2366,2142,224,0.905325443786982,0.0946745562130178
29189219500,29189219500,7047,6586,461,0.934582091670214,0.0654179083297858
29189219600,29189219600,6607,5981,626,0.905252005448766,0.0947479945512335
29189219800,29189219800,7435,6827,608,0.9182246133154,0.0817753866845998
29189220443,29189220443,4255,4044,211,0.950411280846063,0.0495887191539366
29189220601,29189220601,6477,6046,431,0.933456847305851,0.0665431526941486
29189220703,29189220703,2589,2448,141,0.945538818076477,0.0544611819235226
29189220801,29189220801,5348,4960,388,0.927449513836948,0.0725504861630516
29189220803,29189220803,4761,4521,240,0.949590422180214,0.0504095778197857
29189221301,29189221301,7345,7002,343,0.953301565690946,0.0466984343090537
29189221424,29189221424,4996,4743,253,0.949359487590072,0.050640512409928
29189221621,29189221621,4376,4171,205,0.953153564899452,0.0468464351005484
29189221628,29189221628,6717,5667,1050,0.84368021438142,0.15631978561858
29189221629,29189221629,5587,4962,625,0.888133166278862,0.111866833721138
29189221800,29189221800,3565,304,3261,0.085273492286115,0.914726507713885
29219820103,29219820103,7141,6437,704,0.901414367735611,0.0985856322643888
29219820201,29219820201,2216,2144,72,0.967509025270758,0.0324909747292419
29219820202,29219820202,7508,7363,145,0.98068726691529,0.0193127330847096
29221460200,29221460200,4785,4670,115,0.975966562173459,0.0240334378265413
29510101500,29510101500,3126,1960,1166,0.626999360204734,0.373000639795266
29510102200,29510102200,6028,5701,327,0.945753151957532,0.0542468480424685
29510102500,29510102500,1918,1722,196,0.897810218978102,0.102189781021898
29510103100,29510103100,3299,2924,375,0.886329190663838,0.113670809336162
29510103600,29510103600,1329,1183,146,0.890142964635064,0.109857035364936
29510104500,29510104500,1846,1423,423,0.770855904658722,0.229144095341278
29510105198,29510105198,3463,2453,1010,0.708345365290211,0.291654634709789
29510105200,29510105200,2675,995,1680,0.37196261682243,0.62803738317757
29510105300,29510105300,2203,133,2070,0.0603722197004085,0.939627780299591
29510105400,29510105400,2507,223,2284,0.088950937375349,0.911049062624651
29510105500,29510105500,2922,83,2839,0.0284052019164956,0.971594798083504
29510106100,29510106100,2427,26,2401,0.0107128141738772,0.989287185826123
29510106200,29510106200,1738,18,1720,0.0103567318757192,0.989643268124281
29510106300,29510106300,1966,16,1950,0.0081383519837233,0.991861648016277
29510106400,29510106400,2392,22,2370,0.00919732441471572,0.990802675585284
29510106500,29510106500,3267,104,3163,0.0318334863789409,0.968166513621059
29510106600,29510106600,1783,15,1768,0.00841278743690409,0.991587212563096
29510106700,29510106700,3515,50,3465,0.0142247510668563,0.985775248933144
29510107200,29510107200,1342,20,1322,0.014903129657228,0.985096870342772
29510107400,29510107400,2788,33,2755,0.0118364418938307,0.988163558106169
29510107500,29510107500,2711,37,2674,0.0136481003319808,0.986351899668019
29510107600,29510107600,2225,7,2218,0.00314606741573034,0.99685393258427
29510108100,29510108100,3403,142,3261,0.0417278871583897,0.95827211284161
29510109600,29510109600,3316,16,3300,0.00482509047044632,0.995174909529554
29510109700,29510109700,2487,115,2372,0.0462404503417772,0.953759549658223
29510110100,29510110100,2984,34,2950,0.0113941018766756,0.988605898123324
29510110200,29510110200,2654,44,2610,0.0165787490580256,0.983421250941974
29510110400,29510110400,2539,35,2504,0.0137849547065774,0.986215045293423
29510110500,29510110500,1562,30,1532,0.0192061459667093,0.980793854033291
29510111100,29510111100,1556,46,1510,0.0295629820051414,0.970437017994859
29510111200,29510111200,1276,77,1199,0.0603448275862069,0.939655172413793
29510111300,29510111300,1554,13,1541,0.00836550836550837,0.991634491634492
29510111500,29510111500,1010,23,987,0.0227722772277228,0.977227722772277
29510112200,29510112200,1586,54,1532,0.0340479192938209,0.965952080706179
29510112300,29510112300,2415,26,2389,0.0107660455486542,0.989233954451346
29510112400,29510112400,4023,2741,1282,0.68133233905046,0.31866766094954
29510115600,29510115600,5279,2409,2870,0.456336427353665,0.543663572646335
29510116100,29510116100,3274,1553,1721,0.474343310934637,0.525656689065363
29510117400,29510117400,4235,2404,1831,0.567650531286895,0.432349468713105
29510118100,29510118100,1324,355,969,0.268126888217523,0.731873111782477
29510118400,29510118400,1159,728,431,0.628127696289905,0.371872303710095
29510118600,29510118600,3421,1635,1786,0.477930429698918,0.522069570301082
29510119200,29510119200,1703,623,1080,0.365825014679977,0.634174985320023
29510119300,29510119300,5454,3313,2141,0.607444077741107,0.392555922258893
29510120200,29510120200,1271,121,1150,0.0952006294256491,0.904799370574351
29510121200,29510121200,2474,19,2455,0.00767987065481002,0.99232012934519
29510123100,29510123100,3351,964,2387,0.287675320799761,0.712324679200239
29510125500,29510125500,2885,1738,1147,0.602426343154246,0.397573656845754
29510126600,29510126600,3543,663,2880,0.187129551227773,0.812870448772227
29510126700,29510126700,1258,284,974,0.225755166931638,0.774244833068362
29510127100,29510127100,2234,60,2174,0.026857654431513,0.973142345568487
29510127200,29510127200,4075,3100,975,0.760736196319018,0.239263803680982
29510127500,29510127500,2237,521,1716,0.232901206973625,0.767098793026375
17083010200,17083010200,3494,3381,113,0.967658843732112,0.0323411562678878
17083010402,17083010402,2172,2156,16,0.992633517495396,0.00736648250460403
17083010500,17083010500,1633,1584,49,0.969993876301286,0.030006123698714
17117956700,17117956700,4326,4086,240,0.944521497919556,0.0554785020804438
17117956800,17117956800,2742,2698,44,0.983953318745441,0.0160466812545588
17117956900,17117956900,3754,3671,83,0.977890250399574,0.0221097496004262
17117957000,17117957000,3769,3685,84,0.977712921199257,0.0222870788007429
17117957200,17117957200,4959,4841,118,0.976204880016132,0.0237951199838677
17119400101,17119400101,2703,2509,194,0.928227894931558,0.0717721050684424
17119400102,17119400102,5603,4792,811,0.855256112796716,0.144743887203284
17119400200,17119400200,4327,3677,650,0.849780448347585,0.150219551652415
17119400700,17119400700,1890,63,1827,0.0333333333333333,0.966666666666667
17119400802,17119400802,6188,5654,534,0.913703943115708,0.0862960568842922
17119400903,17119400903,5323,4299,1024,0.807627277850836,0.192372722149164
17119400904,17119400904,3364,3226,138,0.9589774078478,0.0410225921521997
17119400951,17119400951,4966,4694,272,0.945227547321788,0.0547724526782118
17119400952,17119400952,3335,2836,499,0.850374812593703,0.149625187406297
17119401000,17119401000,2583,2502,81,0.968641114982578,0.0313588850174216
17119401100,17119401100,6505,6273,232,0.964335126825519,0.0356648731744812
17119401701,17119401701,2570,2226,344,0.866147859922179,0.133852140077821
17119401721,17119401721,5797,5629,168,0.971019492841125,0.0289805071588752
17119401722,17119401722,2684,2614,70,0.973919523099851,0.026080476900149
17119401800,17119401800,6033,5856,177,0.970661362506216,0.0293386374937842
17119401901,17119401901,1841,1777,64,0.96523628462792,0.0347637153720803
17119401903,17119401903,4488,4268,220,0.950980392156863,0.0490196078431373
17119401904,17119401904,709,696,13,0.981664315937941,0.0183356840620592
17119402100,17119402100,3321,1576,1745,0.474555856669678,0.525444143330322
17119402300,17119402300,1876,1525,351,0.812899786780384,0.187100213219616
17119402600,17119402600,2800,1935,865,0.691071428571429,0.308928571428571
17119402722,17119402722,2891,2757,134,0.953649256312695,0.0463507436873054
17119402801,17119402801,3527,3315,212,0.939892259710802,0.0601077402891976
17119402802,17119402802,8158,7933,225,0.97241971071341,0.0275802892865898
17119402803,17119402803,3545,3380,165,0.95345557122708,0.0465444287729196
17119402900,17119402900,4485,3921,564,0.874247491638796,0.125752508361204
17119403001,17119403001,5077,4433,644,0.873153437069135,0.126846562930865
17119403101,17119403101,5885,4787,1098,0.813423959218352,0.186576040781648
17119403121,17119403121,9285,8348,937,0.899084544964997,0.100915455035003
17119403122,17119403122,5539,4711,828,0.850514533309262,0.149485466690738
17119403300,17119403300,3102,2629,473,0.847517730496454,0.152482269503546
17119403401,17119403401,3923,3258,665,0.830486872291614,0.169513127708386
17119403402,17119403402,6031,4887,1144,0.810313380865528,0.189686619134472
17119403502,17119403502,6152,5511,641,0.895806241872562,0.104193758127438
17119403531,17119403531,8226,7764,462,0.943836615609045,0.0561633843909555
17119403532,17119403532,4700,4482,218,0.953617021276596,0.0463829787234042
17119403533,17119403533,9632,8965,667,0.930751661129568,0.0692483388704319
17119403534,17119403534,4093,3782,311,0.92401661373076,0.0759833862692402
17119403603,17119403603,1891,1832,59,0.968799576943416,0.0312004230565838
17119403604,17119403604,6619,6450,169,0.974467442211814,0.0255325577881855
17119403701,17119403701,6159,5946,213,0.965416463711641,0.0345835362883585
17119403801,17119403801,4907,4821,86,0.982474016710821,0.0175259832891788
17119404000,17119404000,2788,2175,613,0.78012912482066,0.21987087517934
17133600101,17133600101,7074,6906,168,0.976251060220526,0.0237489397794741
17133600102,17133600102,4814,4707,107,0.977773161611965,0.0222268383880349
17133600401,17133600401,6396,6276,120,0.981238273921201,0.0187617260787992
17133600402,17133600402,4447,4371,76,0.982909826849562,0.0170901731504385
17133600501,17133600501,6888,6752,136,0.980255516840883,0.0197444831591173
17133600502,17133600502,3338,3275,63,0.981126423007789,0.0188735769922109
17157950500,17157950500,2286,2177,109,0.952318460192476,0.0476815398075241
17157950600,17157950600,4380,3510,870,0.801369863013699,0.198630136986301
17157950700,17157950700,2670,2621,49,0.981647940074906,0.0183520599250936
17157950900,17157950900,3598,3530,68,0.981100611450806,0.018899388549194
17157951000,17157951000,2772,2731,41,0.985209235209235,0.0147907647907648
17157951100,17157951100,3638,3508,130,0.964266080263881,0.0357339197361187
17163501501,17163501501,1812,704,1108,0.388520971302428,0.611479028697572
17163501502,17163501502,2884,1979,905,0.68619972260749,0.31380027739251
17163501602,17163501602,5345,3641,1704,0.681197380729654,0.318802619270346
17163501603,17163501603,6385,4264,2121,0.667815191855912,0.332184808144088
17163501900,17163501900,3620,3079,541,0.850552486187845,0.149447513812155
17163502100,17163502100,2582,1401,1181,0.542602633617351,0.457397366382649
17163502404,17163502404,4161,2422,1739,0.582071617399664,0.417928382600336
17163503100,17163503100,7666,7310,356,0.953561179232977,0.0464388207670232
17163503203,17163503203,6718,6620,98,0.985412325096755,0.014587674903245
17163503301,17163503301,3989,3115,874,0.780897468037102,0.219102531962898
17163503304,17163503304,6952,5361,1591,0.77114499424626,0.22885500575374
17163503322,17163503322,7148,5576,1572,0.780078343592613,0.219921656407387
17163503323,17163503323,6245,5047,1198,0.808166533226581,0.191833466773419
17163503324,17163503324,5675,3141,2534,0.553480176211454,0.446519823788546
17163503332,17163503332,5265,3338,1927,0.633998100664767,0.366001899335233
17163503334,17163503334,6570,4347,2223,0.661643835616438,0.338356164383562
17163503402,17163503402,7627,5148,2479,0.674970499541104,0.325029500458896
17163503411,17163503411,3391,2901,490,0.85549985255087,0.14450014744913
17163503412,17163503412,6330,5531,799,0.873775671406003,0.126224328593997
17163503413,17163503413,5838,3611,2227,0.618533744433025,0.381466255566975
17163503414,17163503414,4557,3292,1265,0.722405091068686,0.277594908931314
17163503906,17163503906,5471,5300,171,0.968744288064339,0.0312557119356608
17163504001,17163504001,4901,4798,103,0.978983880840645,0.0210161191593552
17163504002,17163504002,5909,5781,128,0.978338128278897,0.0216618717211035
17163504303,17163504303,7810,7011,799,0.897695262483995,0.102304737516005
17163504351,17163504351,3596,2757,839,0.766685205784205,0.233314794215795
17163504352,17163504352,4317,3558,759,0.824183460736623,0.175816539263377
17163504353,17163504353,4142,3483,659,0.840898116851762,0.159101883148238
17163504354,17163504354,5990,4363,1627,0.728380634390651,0.271619365609349
17163504355,17163504355,5146,4093,1053,0.795375048581422,0.204624951418578
17163504500,17163504500,5085,52,5033,0.0102261553588987,0.989773844641101
17163504600,17163504600,2229,27,2202,0.0121130551816958,0.987886944818304
17013951300,17013951300,2408,2392,16,0.993355481727575,0.00664451827242529
17083010100,17083010100,5150,5021,129,0.97495145631068,0.0250485436893204
17083010300,17083010300,4173,4056,117,0.97196261682243,0.0280373831775701
17083010401,17083010401,6363,6233,130,0.97956938550998,0.0204306144900205
17117956600,17117956600,4804,4700,104,0.978351373855121,0.0216486261448793
17117957100,17117957100,2688,2654,34,0.98735119047619,0.0126488095238095
17119400600,17119400600,3061,1034,2027,0.337798105194381,0.662201894805619
17119400801,17119400801,1905,1808,97,0.949081364829396,0.0509186351706037
17119401200,17119401200,1841,1805,36,0.980445410103205,0.0195545898967953
17119401300,17119401300,5198,4915,283,0.945555983070412,0.0544440169295883
17119401400,17119401400,3326,2936,390,0.882742032471437,0.117257967528563
17119401500,17119401500,2763,2382,381,0.862106406080347,0.137893593919653
17119402000,17119402000,4403,3101,1302,0.70429252782194,0.29570747217806
17119402200,17119402200,3395,2127,1268,0.626509572901325,0.373490427098675
17119402400,17119402400,1804,1219,585,0.675720620842572,0.324279379157428
17119402500,17119402500,2222,949,1273,0.427092709270927,0.572907290729073
17119402701,17119402701,7517,6597,920,0.877610748969004,0.122389251030996
17119402721,17119402721,7572,7021,551,0.927231907025885,0.0727680929741151
17119403002,17119403002,7386,6597,789,0.893176279447604,0.106823720552396
17119403200,17119403200,4649,4193,456,0.901914390191439,0.098085609808561
17119403601,17119403601,3261,3161,100,0.969334559950935,0.0306654400490647
17119403702,17119403702,5774,5690,84,0.985452026324905,0.0145479736750953
17119403802,17119403802,4596,4489,107,0.976718885987816,0.0232811140121845
17119404100,17119404100,3088,2903,185,0.94009067357513,0.0599093264248705
17157950800,17157950800,4653,4572,81,0.982591876208897,0.0174081237911026
17163500400,17163500400,1826,9,1817,0.00492880613362541,0.995071193866375
17163500500,17163500500,2685,5,2680,0.00186219739292365,0.998137802607076
17163500900,17163500900,3813,27,3786,0.00708103855232101,0.992918961447679
17163501100,17163501100,1777,5,1772,0.0028137310073157,0.997186268992684
17163501200,17163501200,3464,22,3442,0.00635103926096998,0.99364896073903
17163501300,17163501300,3782,37,3745,0.00978318350079323,0.990216816499207
17163501400,17163501400,2790,47,2743,0.0168458781362007,0.983154121863799
17163501604,17163501604,4587,2514,2073,0.54807063440157,0.45192936559843
17163501605,17163501605,2639,2113,526,0.800682076544145,0.199317923455855
17163501700,17163501700,3264,2120,1144,0.649509803921569,0.350490196078431
17163501800,17163501800,5865,4619,1246,0.787553282182438,0.212446717817562
17163502200,17163502200,2101,117,1984,0.0556877677296525,0.944312232270347
17163502300,17163502300,6415,2400,4015,0.374123148869836,0.625876851130164
17163502401,17163502401,1394,43,1351,0.0308464849354376,0.969153515064562
17163502500,17163502500,1272,7,1265,0.00550314465408805,0.994496855345912
17163502602,17163502602,5884,2092,3792,0.355540448674371,0.644459551325629
17163502603,17163502603,4210,1161,3049,0.275771971496437,0.724228028503563
17163502700,17163502700,1251,6,1245,0.00479616306954436,0.995203836930456
17163502800,17163502800,2713,57,2656,0.0210099520825654,0.978990047917435
17163502900,17163502900,2085,41,2044,0.0196642685851319,0.980335731414868
17163503202,17163503202,6110,5188,922,0.849099836333879,0.150900163666121
17163503211,17163503211,4247,3346,901,0.787850247233341,0.212149752766659
17163503404,17163503404,4671,3883,788,0.831299507600086,0.168700492399914
17163503800,17163503800,1292,1058,234,0.818885448916409,0.181114551083591
17163503903,17163503903,3385,3110,275,0.918759231905465,0.0812407680945347
17163503904,17163503904,10394,7885,2509,0.758610736963633,0.241389263036367
17163503905,17163503905,2966,2902,64,0.978422117329737,0.0215778826702629
17163504302,17163504302,7818,6593,1225,0.843310309542082,0.156689690457918
